sarah won .	sarah menang .
grab gary .	tangkap gary .
i hit johnny .	aku memukul johnny .
kim cried .	kim menangis .
who s lee ?	lee itu siapa ?
hello kim .	halo kim !
is mommy ill ?	apa ibu sakit ?
jack did it .	jack melakukannya .
david was ok .	david dalam keadaan baik .
billy s home .	billy di rumah .
was he michael ?	apakah dia michael ?
who is sarah ?	sarah itu siapa ?
is michael sick ?	apa michael sakit ?
is sarah well ?	apa sarah sehat ?
look at ken .	lihatlah ke arah ken .
this is john .	ini john .
lee fainted .	lee pingsan .
vijay is rude .	vijay adalah seorang yang kasar .
gary s flaky .	gary itu suka berpangku tangan .
we help mommy .	kami membantu ibu .
has maria gone ?	sudahkah maria pergi ?
carrie hates me .	carrie membenciku .
gary is tense .	gary tidak tenang .
ken needs it .	ken membutuhkannya .
gary saw them .	gary melihat mereka .
mia stutters .	mia berbicara dengan gagap .
david was fine .	david dalam keadaan baik .
billy was good .	billy dalam keadaan baik .
ken s polite .	ken itu ramah .
mia s strict .	mia itu keras .
i can see carrie .	aku bisa melihat carrie .
jack blames us .	jack menyalahkan kami .
darren is cranky .	darren bete .
ken is immune .	ken kebal .
maria is polite .	maria itu ramah .
michael looks bad .	michael terlihat buruk .
mommy was fired .	ibu dipecat .
ken was happy .	ken merasa bahagia .
johnny was lucky .	johnny beruntung .
we helped michael .	kami membantu michael .
it must be maria .	itu pasti maria .
keep maria quiet .	jaga agar maria tetap diam .
mia ignored me .	mia mengabaikanku .
lim is at home .	lim ada di rumah .
carrie is jittery .	carrie gelisah .
ken is nervous .	ken gugup .
gary isn t weak .	gary tidak lemah .
darren passed out .	darren pingsan .
carrie was crying .	carrie menangis .
billy was eating .	billy sedang makan tadi .
nancy works hard .	nancy bekerja dengan keras .
mia s not weak .	mia tidak lemah .
can i bring ken ?	boleh aku mengajak ken ?
i don t see daddy .	aku tidak melihat ayah .
i surprised johnny .	aku mengangetkan johnny .
daddy blacked out .	ayah pingsan .
david is home now .	david sedang di rumah sekarang .
darren is my buddy .	darren adalah temanku .
ken is very old .	ken sangat tua .
maria kept eating .	maria terus makan .
carrie lied to you .	carrie berbohong padamu .
daddy looks upset .	ayah terlihat sedih .
mommy needs a cab .	ibu butuh taksi .
john needs water .	john butuh air .
jack quit school .	jack berhenti sekolah .
mommy seems upset .	ibu sepertinya sedih .
carrie was injured .	carrie telah terluka .
gary was singing .	gary sedang bernyanyi tadi .
lee s concerned .	lee khawatir .
vijay s dangerous .	vijay itu berbahaya .
vijay s my friend .	vijay itu temanku .
we captured john .	kita menangkap john .
i ll be with ken .	aku dengan ken .
i m maria s driver .	saya supir maria .
my svijayach hurts .	perutku sakit .
carrie became blind .	carrie menjadi buta .
john has a butler .	john punya kepala pelayan .
vijay helped a lot .	vijay membantu banyak .
vijay hurt his leg .	kaki vijay terluka .
lim is a student .	lim adalah seorang siswa .
jack is courteous .	jack itu ramah .
johnny is easygoing .	johnny itu santai .
john is forgetful .	john itu pelupa .
david is my friend .	david adalah temanku .
billy isn t famous .	billy tidak terkenal .
michael kept talking .	michael terus berbicara .
sarah lost his hat .	sarah kehilangan topinya .
lim lost his job .	lim kehilangan pekerjaannya .
michael sounds upset .	michael sepertinya sedih .
ken studies hard .	ken belajar dengan tekun .
ken walks slowly .	ken berjalan dengan pelan .
john was divorced .	john diceraikan .
david was poisoned .	david keracunan .
michael was worn out .	michael kelelahan .
jack will improve .	jack akan berkembang .
lim s quite good .	lim lumayan bagus .
where is cuscarries ?	di mana bea dan cukai ?
don t you see mommy ?	apakah kamu melihat ibu ?
i met nancy tonight .	aku bertemu nancy malam ini .
i saw vijay earlier .	barusan aku melihat vijay .
is carrie still sick ?	apakah carrie masih sakit ?
vijay broke the law .	vijay melanggar hukum .
jack gave me a pen .	jack memberiku sebuah pena .
ken has been good .	ken selalu dalam keadaan baik .
lim has lost hope .	lim telah kehilangan harapan .
lim is a bit pale .	lim agak pucat .
sarah is a bookworm .	sarah itu kutu buku .
lee is a good guy .	lee adalah pria yang baik .
jack is a good man .	jack adalah pria yang baik .
mommy is a murderer .	ibu seorang pembunuh .
david is distressed .	david tertekan .
ken is having fun .	ken sedang bersenang senang .
nancy is in the car .	nancy sedang berada di dalam mobil .
maria is not famous .	maria tidak terkenal .
daddy is quite good .	ayah lumayan bagus .
gary is stuttering .	gary berbicara dengan gagap .
carrie is unemployed .	carrie adalah seorang penganggur .
vijay is very funny .	vijay sangat lucu .
mommy isn t thirsty .	ibu tidak haus .
sarah looks baffled .	sarah terlihat kebingungan .
mommy looks puzzled .	ibu terlihat kebingungan .
johnny looks shocked .	johnny terlihat syok .
kim misses boston .	kim merindukan boston .
maria seems puzzled .	maria sepertinya kebingungan .
vijay seems shocked .	vijay sepertinya syok .
ken seems stunned .	ken sepertinya terkejut .
billy set the table .	billy mengatur meja .
ken shut his eyes .	ken memejamkan mata .
david staggered out .	david terhuyung huyung keluar .
david stood in line .	david berjajar dalam barisan .
nancy used to smoke .	nancy dulunya merokok .
darren was delighted .	darren merasa gembira .
lim was exhausted .	lim kelelahan .
sarah was fortunate .	sarah beruntung .
lim are you okay ?	lim kamu gak apa apa ?
jackorrow s payday .	besok hari gajian .
we re helping mommy .	kami sedang membantu ibu .
when did sarah call ?	kapan sarah menelepon ?
where s david today ?	di mana david hari ini ?
does michael work here ?	apakah michael bekerja di sini ?
i broke carrie s nose .	aku melukai hidung carrie .
i told jack to stop .	aku menyuruh jack untuk berhenti .
is ken left handed ?	apakah ken kidal ?
may i speak to daddy ?	bisakah saya berbicara dengan ayah ?
gary broke that one .	gary merusakkan yang satu itu .
david didn t mean it .	david tidak bermaksud demikian .
nancy has a headache .	nancy sakit kepala .
gary has been awful .	gary sedang tidak bahagia .
nancy has passed out .	nancy pingsan .
jack is mary s boss .	jack adalah bos dari mary .
michael is a bartender .	michael adalah seorang pelayan bar .
johnny is a good cook .	johnny adalah seorang yang pandai memasak .
lim is at home now .	lim sedang di rumah sekarang .
billy is on the dock .	billy ada di dok .
mia is pretty good .	mia sangat bagus .
ken looked at mary .	ken melihat kepada mary .
mommy looked puzzled .	ibu terlihat kebingungan .
gary looks confused .	gary terlihat kebingungan .
john must be asleep .	john pasti tertidur .
mommy must be lonely .	ibu pasti kesepian .
daddy needs a friend .	ayah membutuhkan seorang teman .
jack seems confused .	jack sepertinya kebingungan .
ken should be here .	ken seharusnya ada di sini .
gary won t hurt you .	gary tidak akan menyakitimu .
john works too much .	john terlalu banyak bekerja .
kim you re a liar .	kim kamu pembohong .
limorrow is payday .	besok hari gajian .
what did lim think ?	apa yang telah lim pikirkan ?
i get paid kenorrow .	aku dapat gaji besok .
i have to visit gary .	aku harus mengunjungi gary .
i know what johnny saw .	aku tahu apa yang johnny lihat .
i ll stick with mia .	aku dengan mia .
let jack come aboard .	biarkan jack naik .
let s do it for carrie .	mari kita melakukannya untuk carrie .
let s let mia do it .	mari kita biarkan mia yang melakukannya .
johnny abused my trust .	johnny menyalahgunakan kepercayaan yang aku berikan .
ken appears stunned .	ken kelihatannya terkejut .
billy bought me roses .	billy membelikanku bunga mawar .
michael came here alone .	michael datang kemari sendirian .
kim closed his eyes .	kim memejamkan mata .
billy doesn t know me .	billy tidak mengetahui saya .
daddy drives too fast .	ayah mengemudi terlalu cepat .
mia found me a taxi .	mia mencarikanku sebuah taksi .
daddy has lied to you .	ayah sudah berbohong padamu .
darren is mary s uncle .	darren adalah paman mary .
daddy is a politician .	ayah adalah seorang politikus .
mommy is all business .	ibu terlalu serius .
mommy is having lunch .	ibu sedang makan siang .
johnny is ignoring you .	johnny mengabaikanmu .
lim is in the house .	lim ada di dalam rumah .
jack kept on talking .	jack terus berbicara .
darren looked confused .	darren terlihat kebingungan .
billy looks perplexed .	billy terlihat kebingungan .
mommy must be stopped .	ibu harus dihentikan .
vijay needed training .	vijay membutuhkan pelatihan .
lim remains puzzled .	lim masih bingung .
darren says he ll come .	darren bilang ia akan datang .
darren shut the drawer .	darren menutup lacinya .
lee started to sing .	lee mulai bernyanyi .
david was very scared .	david sangat ketakutan .
mommy went home alone .	ibu pulang ke rumah sendirian .
johnny went on talking .	johnny lanjut berbicara .
jack s eyes are blue .	mata jack biru .
mia s eyes are blue .	mia matanya biru .
david s face was pale .	muka david pucat
we can count on vijay .	kami dapat mempercayai vijay .
what does carrie think ?	apa yang carrie pikirkan ?
i have a sjohnachache .	perutku sakit .
i owe my life to john .	aku berhutang nyawa kepada john .
it could ve been sarah .	itu mungkin sarah .
lee appears confused .	lee terlihat kebingungan .
billy became irritated .	billy merasa jengkel .
mia doesn t trust us .	mia tidak mempercayai kita .
vijay finally met mary .	vijay akhirnya bertemu dengan mary .
lee has good manners .	lee punya sopan santun .
lee ironed his shirt .	lee menyetrika bajunya .
nancy is a red sox fan .	nancy adalah penggemar dari red sox .
ken is a good person .	ken adalah orang yang baik .
jack is a good worker .	jack adalah pekerja yang baik .
david is a nice person .	david adalah orang yang baik .
vijay is conscientious .	vijay adalah seorang yang teliti .
jack is older than me .	jack lebih tua ketimbang aku .
vijay is the strongest .	vijaylah yang terkuat .
nancy looks bewildered .	nancy terlihat bimbang .
daddy looks nonplussed .	ayah tampak tercengang .
lim never backs down .	lim tidak pernah mundur .
carrie resumed speaking .	carrie lanjut berbicara .
billy seems bewildered .	billy sepertinya bimbang .
sarah speaks very fast .	sarah berbicara sangat cepat .
john speaks very fast .	john berbicara dengan sangat cepat .
mommy told me about it .	ibu memberitahuku tentang hal itu .
nancy used to be happy .	nancy dulu bahagia .
darren was all worn out .	darren benar benar kelelahan .
daddy was good at that .	ayah sangat baik dalam hal itu .
johnny was lying to you .	johnny sudah berbohong padamu .
carrie went on speaking .	carrie lanjut berbicara .
daddy won t let you go .	ayah tidak akan membiarkanmu pergi .
we had to let lee go .	kita harus membiarkan lee pergi .
what grade is vijay in ?	kelas berapa vijay ?
what grade is john in ?	john kelas berapa ?
when is john arriving ?	kapan john akan tiba ?
does darren like to swim ?	apakah darren suka berenang ?
has vijay said anything ?	apakah vijay mengatakan sesuatu ?
his dad calls him lim .	ayahnya memanggilnya lim .
i saw darren in the hall .	aku melihat darren di aula .
i saw darren in the hall .	aku melihat darren di lorong .
carrie and mary are done .	carrie dan mary putus .
ken appeared confused .	ken terlihat kebingungan .
maria can t play tennis .	maria tidak bisa bermain tenis .
mia clapped his hands .	mia bertepuk tangan .
johnny closed the drawer .	johnny menutup lacinya .
john continued talking .	john lanjut berbicara .
johnny did as i told him .	johnny melakukan apa yang aku katakan .
nancy doesn t like beef .	nancy tidak suka daging sapi .
lee has a pretty wife .	lee mempunyai istri yang cantik .
maria has a smariaachache .	maria sakit perut .
billy has been expelled .	billy telah dikeluarkan .
mia has been poisoned .	mia telah diracuni .
mommy has to be stopped .	ibu harus dihentikan .
lee is always bananas .	lee selalu konyol .
vijay is always healthy .	vijay selalu sehat .
mia is bigger than me .	mia lebih besar ketimbang aku .
michael is reading a book .	michael sedang membaca buku .
lee is taller than me .	lee lebih tinggi daripada aku .
michael isn t the traitor .	michael bukanlah penghianat .
gary looks dumbfounded .	gary tampak tercengang .
johnny misses his family .	johnny merindukan keluarganya .
lim refused to let go .	lim menolak untuk melepas .
jack spoke up for mary .	jack berbicara untuk mary .
gary studies very hard .	gary sangat tekun belajar .
daddy was quite helpful .	ayah sudah cukup membantu .
vijay wouldn t sit down .	vijay tidak akan duduk .
watch your mouth kim .	jaga mulutmu kim .
what if johnny finds out ?	bagaimana kalau johnny mengetahuinya ?
when did gary buy that ?	kapan gary membeli itu ?
where s david moving to ?	david pindah ke mana ?
you re older than michael .	kamu lebih tua daripada michael .
how long was david there ?	sudah berapa lama david di sana ?
i have to find johnny now .	aku harus menemukan johnny sekarang .
i know gary is innocent .	aku tahu gary tidak bersalah .
i told mia a few jokes .	aku memberitahu mia beberapa lelucon .
it might rain leeorrow .	hujan mungkin akan turun besok .
thanks for helping daddy .	terima kasih telah membantu ayah .
today s john s birthday .	hari ini ulang tahun john .
lim continued speaking .	lim lanjut berbicara .
ken continued to speak .	ken lanjut berbicara .
mia could replace mary .	mia bisa menggantikan mary .
jack crossed the street .	jack menyeberangi jalan itu .
vijay doesn t have a car .	vijay tidak punya mobil .
kim dreamed about mary .	kim memimpikan mary
gary explained it to me .	gary menjelaskannya padaku .
lim flushed the toilet .	lim menyiram toilet .
ken got out of his car .	ken keluar dari mobilnya .
daddy got out of the car .	ayah keluar dari mobil .
mommy had a very bad day .	ibu menghadapi hari yang sangat buruk .
billy is a buddy of mine .	billy adalah seorang kawanku .
mommy is a good employee .	ibu adalah pegawai yang baik .
vijay is afraid of dying .	vijay takut mati .
michael is alone with mary .	michael sedang berduaan dengan mary .
carrie is beating up mary .	carrie memukuli mary .
vijay is getting jealous .	vijay mulai cemburu .
maria is good at cooking .	maria pandai dalam hal memasak .
maria is looking for you .	maria sedang mencarimu .
maria looks just like me .	maria tampak seperti diriku .
kim really misses mary .	kim sungguh merindukan mary .
lim says he s innocent .	lim berkata dia tidak bersalah .
ken set down his spoon .	ken meletakkan sendoknya .
lee should just resign .	lee sebaiknya mengundurkan diri .
sarah stayed for a while .	sarah tinggal selama beberapa waktu .
lee wants to kill mary .	lee ingin membunuh mary .
sarah was a little drunk .	sarah sedikit mabuk .
gary was very surprised .	gary sangat terkejut .
we ve been helping carrie .	kami selalu membantu carrie .
what s your major ken ?	apa jurusanmu ken ?
will you come kenorrow ?	apakah kau akan datang besok ?
you should ve told johnny .	harusnya kamu memberi tahu johnny .
did daddy know what to do ?	apa ayah tahu apa yang harus ia lakukan ?
how do you do that ken ?	bagaimana kamu melakukannya ken ?
i couldn t convince jack .	aku tidak bisa membujuk jack .
i know jack isn t guilty .	aku tahu jack tidak salah .
i know why michael resigned .	aku tahu kenapa michael mengundurkan diri .
i think david is loveable .	saya pikir david mudah disukai .
i think sarah is sensible .	aku pikir sarah adalah orang yang bijaksana .
i think daddy should stay .	aku pikir ayah harus tetap tinggal .
i ll be better leeorrow .	aku akan baik baik saja besok .
today is jack s birthday .	hari ini ulang tahun jack .
jack began to understand .	jack mulai mengerti .
lim can t run very fast .	lim tidak bisa lari dengan sangat cepat .
jack cut himself shaving .	jack terluka ketika sedang bercukur .
maria didn t try to argue .	maria tidak mencoba untuk membantah .
kim doesn t like cheese .	kim tidak suka keju .
nancy dug up the potatoes .	nancy memanen kentang kentangnya .
gary fell into the water .	gary jatuh ke dalam air .
maria had to do some work .	maria harus melakukan beberapa perkerjaan .
mommy has a decent salary .	ibu punya gaji yang lumayan .
vijay has another problem .	vijay punya permasalahan lain .
daddy has been good to me .	ayah selalu baik kepadaku .
johnny has been good to us .	johnny selalu baik kepada kami .
billy has good intentions .	billy memiliki niat yang baik .
sarah hid under the table .	sarah bersembunyi di bawah meja .
mia is a friend of mine .	mia adalah seorang kawanku .
carrie is a friend of mine .	carrie adalah seorang temanku .
darren is in constant pain .	darren merasakan sakit yang tidak ada henti hentinya .
lim just wanted to help .	lim hanya ingin membantu .
david likes fried chicken .	david suka ayam goreng .
johnny put on his raincoat .	johnny memakai jas hujan .
david ran across the road .	david berlari sepanjang jalan .
nancy said he s no expert .	nancy berkata dia bukan ahlinya .
maria says the same thing .	maria mengatakan hal yang sama .
nancy says this is absurd .	nancy berkata ini tidak masuk akal .
gary says this is normal .	gary berkata ini normal .
michael seemed uninterested .	michael terlihat tidak tertarik .
daddy signed the document .	ayah menandatangani dokumennya .
billy sleeps all the time .	billy tidur sepanjang waktu .
lim still has some time .	lim masih ada waktu .
gary still loves his job .	gary masih menyukai pekerjaannya .
johnny still loves it here .	johnny masih betah disini .
michael thinks the same way .	michael juga berpikiran sama .
billy thinks you re lying .	billy berpikir kalau kau berbohong .
darren used to be very shy .	darren dulunya sangat pemalu .
carrie wanted to be famous .	carrie ingin terkenal .
david wants to be a pilot .	david ingin menjadi seorang pilot .
michael was late for dinner .	michael terlambat untuk makan malam .
mommy was shocked by this .	ibu syok karena ini .
michael was shot and killed .	michael tertembak dan terbunuh .
kim was shot and killed .	kim ditembak dan dibunuh .
gary was shot and killed .	gary ditembak dan terbunuh .
carrie wasn t a bit sleepy .	carrie tidak sedang mengantuk .
darren will have no choice .	darren tidak akan punya pilihan .
gary will quit on monday .	gary akan berhenti hari senin .
johnny wore a white jacket .	johnny mengenakan jaket putih .
lee worked all his life .	lee bekerja sepanjang hidupnya .
you are a good cusdarrener .	anda seorang pelanggan yang baik .
you can t come daddyorrow .	kamu tidak bisa datang besok .
his father calls him johnny .	ayahnya memanggilnya johnny .
how are you feeling lim ?	bagaimana perasaanmu lim ?
i can t take daddy s money .	aku tidak bisa menerima uang ayah .
i know what michael would do .	aku tahu apa yang akan michael lakukan .
i saw michael in the hallway .	aku melihat michael di lorong .
i ll be at home johnnyorrow .	aku ada di rumah besok .
i m jack and this is mary .	saya jack dan ini mary .
let s hope sarah was right .	semoga saja sarah benar .
they paid cuslims duties .	mereka membayar bea masuk .
vijay came by this morning .	vijay datang pagi ini .
jack could ve been killed .	jack bisa saja terbunuh .
michael didn t want to do it .	michael enggan melakukan itu .
vijay died a natural death .	vijay meninggal dengan wajar .
daddy fell down the stairs .	ayah jatuh dari tangga .
nancy gave mary his kidney .	nancy memberikan mary ginjalnya .
david has to get back home .	david harus pulang ke rumah .
billy is a college student .	billy adalah seorang mahasiswa .
johnny is a convicted felon .	johnny adalah penjahat terhukum .
johnny is acting on his own .	johnny bertindak atas kemauannya sendiri .
vijay is one of my friends .	vijay adalah salah satu dari temanku .
ken is probably sleeping .	ken mungkin sedang tidur .
john is trying not to cry .	john mencoba untuk tidak menangis .
ken isn t afraid to fail .	ken tidak takut gagal .
maria just doesn t like me .	maria hanya tidak suka padaku .
billy knew mary was hungry .	billy tahu mary sedang lapar .
daddy looks a bit confused .	ayah terlihat sedikit kebingungan .
carrie loves being outdoors .	carrie sangat suka berada di luar .
nancy might still be alive .	nancy mungkin masih hidup .
kim never left the house .	kim tidak pernah meninggalkan rumah .
maria never saw mary again .	maria tidak pernah melihat mary lagi .
michael passed away recently .	michael meninggal dunia baru baru ini .
mommy pointed to the floor .	ibu menunjuk lantai .
jack ran down to the lake .	jack berlari ke danau .
mia reached for his cane .	mia meraih tongkatnya .
mommy says he s busy today .	ibu berkata dia sibuk hari ini .
carrie seemed kind of upset .	carrie terlihat seperti sedang sedih .
david stared at the ground .	david melihat ke arah tanah .
david tried to defend mary .	david mencoba untuk melindungi mary .
sarah used to get up early .	sarah terbiasa bangun lebih awal .
john wanted grandchildren .	john menginginkan cucu .
johnny wants to be the boss .	johnny ingin menjadi bosnya .
billy wants to go to japan .	billy ingin pergi ke jepang .
billy was anxious to leave .	billy cemas untuk pergi .
lim was looking for help .	lim sedang mencari pertolongan .
david was murdered by mary .	david dibunuh mary .
carrie went to buy dog food .	carrie pergi membeli makanan anjing .
billyorrow is her birthday .	besok dia berulang tahun .
we ll be seeing you ken .	sampai jumpa lagi ken .
can we get ken to do that ?	apakah kita bisa membuat ken melakukan itu ?
could you look at me mia ?	dapatkah kamu melihatku mia ?
did you get this from ken ?	apakah kamu mendapatkan ini dari ken ?
do you understand me johnny ?	apakah kamu memahami maksudku johnny ?
don t trust what johnny says .	jangan percaya pada apa yang johnny katakan .
go home to your wife john .	pulanglah ke istrimu john .
i just told carrie the truth .	aku cuma memberitahu carrie yang sebenarnya .
i think billy is aggressive .	aku pikir billy adalah seorang yang agresif .
i ll return home carrieorrow .	saya akan pulang kerumah besok .
it s ok to be scared david .	tak apa untuk takut david .
it s ok to be scared nancy .	tidak masalah merasa takut nancy .
it s gary s birthday today .	hari ini ulang tahun gary .
let me say goodbye to kim .	biarkan saya mengucapkan selamat tinggal kepada kim .
maybe i ll leave johnorrow .	mungkin besok saya akan pergi .
maybe mia would like that .	mungkin mia akan menyukai itu .
tell michael i don t like him .	beritahu michael aku tidak suka padanya .
the police can t find michael .	polisi tidak berhasil menemukan michael .
they were waiting for sarah .	mereka sedang menunggu sarah .
michael always makes me laugh .	michael selalu membuatku tertawa .
lee appeared to be crying .	lee kelihatannya menangis .
michael asked us to be silent .	michael meminta kami untuk diam .
johnny clicked off the light .	johnny mematikan lampunya .
johnny clicked the light off .	johnny mematikan lampunya .
billy doesn t like the idea .	billy tidak menyukai ide tersebut .
michael had to clean his room .	michael harus membersihkan kamarnya .
maria has a bad disposition .	maria mempunyai perangai yang buruk .
johnny is mary s best friend .	johnny adalah teman baik mary .
billy is a lot better today .	billy jauh lebih baik hari ini .
johnny is careless isn t he ?	johnny itu masa bodoh kan ?
kim is finishing his work .	kim sedang menyelesaikan pekerjaannya .
nancy is growing a mustache .	nancy menumbuhkan kumis .
kim is here to protect me .	kim di sini untuk melindungiku .
maria is mentally disturbed .	maria terganggu secara mental .
nancy is not in his bedroom .	nancy tidak sedang berada di kamarnya .
nancy is sitting on a chair .	nancy sedang duduk diatas sebuah kursi .
ken isn t afraid of death .	ken tidak takut mati .
mommy isn t as rich as mary .	ibu tidak sekaya mary .
gary isn t very photogenic .	gary tidak terlalu cocok untuk difoto .
david isn t watching tv now .	david tidak sedang menonton tv sekarang .
david knows he s in trouble .	david tahu dia dalam masalah .
mommy likes science fiction .	ibu menyukai sains fiksi .
lee likes to travel alone .	lee suka melakukan perjalanan sendirian .
mia loves science fiction .	mia menyukai sains fiksi .
nancy may have already left .	nancy mungkin saja sudah pergi .
sarah may have been injured .	sarah mungkin saja terluka .
john never arrives on time .	john tidak pernah datang tepat waktu .
mia really likes antiques .	mia sungguh menyukai barang antik .
maria really makes me angry .	maria sungguh membuatku marah .
gary took part in the race .	gary ikut berpartisipasi pada balapan .
maria tried to deceive mary .	maria mencoba menipu mary .
lee wants to meet with me .	lee ingin bertemu denganku .
michael was in seventh heaven .	michael sudah ada di langit ketujuh
daddy was working part time .	ayah bekerja paruh waktu .
johnny wiped the table clean .	johnny mengelap mejanya sampai bersih .
what color are gary s eyes ?	apa warna mata gary ?
what have you done to darren ?	apa yang sudah kau perbuat pada darren ?
what sympjohnnys do you have ?	gejala gejala apa saja yang anda alami ?
why can t we go visit lee ?	kenapa kita tidak bisa mengunjungi lee ?
why do i have to help lim ?	mengapa aku harus menolong lim ?
why doesn t sarah like mary ?	kenapa sarah tidak menyukai mary ?
hang on just a second nancy .	tunggu sebentar nancy .
i know you worry about mommy .	aku tahu kamu khawatir pada ibu .
i will be at home limorrow .	saya ada di rumah besok .
i d like to speak with daddy .	saya ingin berbicara dengan ayah .
that s all david talks about .	itulah yang dibicarakan oleh david .
jack and i aren t strangers .	jack dan aku bukan orang asing .
lim and mary are here too .	lim dan mary juga ada di sini .
daddy and mary are outsiders .	ayah dan mary adalah orang luar .
jack can t make up his mind .	jack tidak dapat memutuskannya .
billy doesn t have an office .	billy tidak punya kantor .
mia goes to school on foot .	mia ke sekolah dengan berjalan kaki .
mommy has confidence in mary .	ibu percaya pada mary .
john has low blood pressure .	john memiliki tekanan darah rendah .
michael is a self educated man .	michael adalah seorang otodidak .
jack is bleeding internally .	jack mengalami pendarahan dalam .
gary is impatient isn t he ?	gary tidak sabaran ya ?
nancy is itching for a fight .	nancy sudah tidak tahan ingin berkelahi .
lim is three years old now .	lim saat ini berusia tiga tahun .
carrie is trying not to laugh .	carrie sedang berusaha untuk tidak tertawa
kim kissed me on the mouth .	kim mencumbuku .
mia lives across the river .	mia tinggal di seberang sungai .
vijay looks busy doesn t he ?	bukankah vijay terlihat sibuk ?
sarah might be seriously ill .	sarah mungkin sedang sakit berat .
lim played a trick on mary .	lim menipu mary .
vijay probably can t do that .	vijay mungkin tidak bisa melakukannya .
john promised me he d do it .	john berjanji padaku bahwa dia akan melakukannya .
darren seemed to be surprised .	darren terlihat terkejut .
ken shot mary with a rifle .	ken menembak mary dengan senapan .
vijay speaks relatively fast .	vijay bicaranya relatif cepat .
sarah walked along the shore .	sarah berjalan di sepanjang tepi pantai .
carrie was working last night .	carrie bekerja semalam .
carrie will go there carrieorrow .	carrie akan pergi ke sana besok .
sarah won t like that answer .	sarah tidak akan menyukai jawaban itu .
carrie s hair has turned gray .	rambut carrie sudah memutih .
we shouldn t have told john .	harusnya kita tidak memberi tahu john .
do you ever think about lee ?	pernahkah kamu memikirkan tentang lee ?
i pushed vijay into the water .	saya mendorong vijay kedalam air .
i still think johnny is guilty .	saya masih berpikir johnny bersalah .
i think carrie should eat more .	aku rasa carrie harus makan lebih banyak .
i want to be as tall as kim .	saya mau setinggi kim
i want you guys to meet david .	aku ingin kalian bertemu dengan david .
i will get it back from maria .	aku akan mengambilnya kembali dari maria .
i will go to tokyo garyorrow .	aku akan pergi ke tokyo besok .
it s good that jack did that .	baguslah jika jack yang melakukannya .
michael and i both like sailing .	michael dan aku sama sama suka berlayar .
sarah doesn t even own a suit .	bahkan sebuah jas saja sarah tidak punya .
carrie finally gave up smoking .	akhirnya carrie berhenti merokok .
billy got home after midnight .	billy sampai di rumah lewat tengah malam .
daddy has everything he needs .	ayah memiliki semua yang ia butuhkan .
gary is a university student .	gary adalah mahasiswa .
jack is obsessed with trains .	jack terobsesi dengan kereta api .
sarah is peeling the potatoes .	sarah sedang mengupasi kentang kentangnya .
billy is playing with his son .	billy bermain dengan anak laki lakinya .
michael is relocating to boston .	michael pindah ke boston .
daddy is waiting for mary now .	ayah sedang menunggu mary sekarang .
kim isn t going to hurt you .	kim tidak akan menyakitimu .
maria knows there s a problem .	maria tahu ada masalah .
billy left school an hour ago .	billy meninggalkan sekolah sejam yang lalu .
ken looks a little confused .	ken terlihat sedikit kebingungan .
carrie looks tired doesn t he ?	bukankah carrie terlihat lelah ?
daddy misses his family a lot .	ayah sangat merindukan keluarganya .
john never even said goodbye .	john tidak pernah mengatakan selamat tinggal .
jack picked a lot of flowers .	jack memetik banyak bunga .
jack proofread my manuscript .	jack memeriksa tulisan saya .
michael ran back into the woods .	michael berlari kembali ke hutan .
carrie ran out into the street .	carrie berlari keluar ke jalan .
jack really likes mary a lot .	jack sangat menyukai mary .
darren said that for the laugh .	darren mengatakannya sebagai hiburan .
daddy says everyone does that .	ayah mengatakan semua orang melakukannya .
jack seems a little confused .	jack sepertinya agak kebingungan .
michael seems to be sympathetic .	michael terlihat bersimpati .
jack shouldn t even be there .	jack bahkan tidak semestinya berada di sana .
darren thanked me for the gift .	darren berterima kasih atas hadiah yang aku berikan padanya .
gary tried to commit suicide .	gary mencoba untuk bunuh diri .
john was completely worn out .	john benar benar kelelahan .
billy wished he had more time .	billy berharap dia memiliki waktu yang lebih panjang .
limorrow i m going to paris .	besok saya pergi ke paris .
vijayorrow is when i get paid .	besok adalah hari di mana aku akan mendapatkan gaji .
we leave mommyorrow afternoon .	kami berangkat besok siang .
you should just talk to ken .	kamu seharusnya langsung berbicara dengan ken .
you shouldn t be alone mommy .	anda seharusnya tidak sendirian ibu .
do you have feelings for kim ?	apakah kamu memiliki perasaan terhadap kim ?
excuse me have you seen john ?	permisi apakah kamu melihat john dimana ?
excuse me is nancy here today ?	permisi apakah nancy di sini hari ini ?
how are you feeling now carrie ?	bagaimana perasaanmu sekarang carrie ?
how does maria feel about that ?	apa yang maria rasakan tentang hal itu ?
how does maria know about that ?	bagaimana maria mengetahui hal itu ?
i am going to tokyo johnorrow .	aku akan pergi ke tokyo besok .
i should ve told mia earlier .	seharusnya aku memberitahu mia lebih awal .
i think maria will return soon .	kurasa maria akan segera kembali .
i think we d better help maria .	aku pikir kita perlu membantu maria .
i will get up early nancyorrow .	aku akan bangun lebih awal besok .
i ll never forget nancy s face .	aku tidak akan pernah melupakan wajah nancy .
it s kim who deserves credit .	kimlah yang pantas mendapatkan penghargaan .
let s just hope kim is alone .	semoga saja kim sendirian .
maybe someone made john do it .	mungkin seseorang membuat john melakukan hal itu .
something was wrong with mommy .	ada yang salah dengan ibu .
jack begged mary not to leave .	jack meminta mary untuk tidak pergi .
kim didn t see the stop sign .	kim tidak melihat rambu berhenti .
maria doesn t get enough sleep .	maria tidak mendapat tidur yang cukup .
david doesn t know anyone here .	david tidak mengenal siapa siapa .
darren got rid of his old books .	darren menyingkirkan buku buku lamanya .
mommy is a computer programmer .	ibu adalah seorang pemrogram komputer .
nancy is a high school student .	nancy adalah seorang siswa sma .
michael is leaving in three days .	michael akan berangkat dalam tiga hari .
david is mowing his front lawn .	david sedang memotong rumput di halaman depannya .
vijay is still in the hospital .	vijay masih berada di rumah sakit .
kim knows he hears something .	kim tahu dia mendengar sesuatu .
darren looked at the fuel gauge .	darren melihat indikator bahan bakar .
vijay looked down at the floor .	vijay melihat ke arah lantai .
maria looked like he was happy .	maria terlihat seperti dia sedang bahagia .
mommy looks sleepy doesn t he ?	bukankah ibu terlihat mengantuk ?
gary lost his reading glasses .	gary kehilangan kacamata bacanya .
lee may not like this at all .	lee mungkin tidak menyukai hal ini sama sekali .
lee met mary three years ago .	lee bertemu mary tiga tahun yang lalu .
ken must ve worked very hard .	ken pasti telah bekerja sangat keras .
maria opened the door for mary .	maria membukakan pintu untuk mary .
lim opened the gate for mary .	lim membukakan gerbang untuk mary .
lee pretended to be ignorant .	lee bertindak seolah olah acuh .
gary put his seatbelt back on .	gary memakai kembali sabuk pengamannya .
daddy quietly entered the room .	ayah diam diam memasuki ruangan itu .
daddy ran back down the stairs .	ayah berlari kembali menuruni tangga .
john really misses his family .	john sangat merindukan keluarganya .
gary saw his name on the list .	gary berkata dia melihat namanya pada daftar .
carrie says i m a good listener .	carrie berkata saya adalah pendengar yang baik .
sarah walked across the street .	sarah berjalan menyeberangi jalan itu .
gary was out with his friends .	gary sedang pergi bersama dengan temannya .
did carrie ask you to write this ?	apakah carrie memintamu untuk menulis ini ?
did you know maria worked there ?	apakah kamu tahu maria berkerja di sana ?
he took billy on a fishing trip .	dia mengajak billy pergi memancing .
how could vijay do this to mary ?	bagaimana bisa vijay melakukan ini pada mary ?
how did your date go with daddy ?	bagaimana jalannya kencanmu dengan ayah ?
how did your date with billy go ?	bagaimana jalannya kencanmu dengan billy ?
i had to respect jack s wishes .	aku harus menghormati keinginan jack .
i knew that daddy wasn t hungry .	aku tahu kalau ayah tidak lapar .
i ll be free all day miaorrow .	saya akan bebas selama seharian besok .
i m afraid johnny might get hurt .	saya khawatir johnny akan terluka .
perhaps it will rain mommyorrow .	mungkin besok akan turun hujan .
that was mia s favorite color .	itu adalah warna favorit mia .
billy applied for a scholarship .	billy mendaftar sebuah beasiswa .
jack asked me where i got this .	jack bertanya padaku dimanakah aku mendapatkan ini .
john came home early yesterday .	john pulang ke rumah lebih awal kemarin .
sarah came home early yesterday .	sarah pulang lebih awal kemarin .
gary could scarcely believe it .	gary hampir tidak mempercayainya .
gary grabbed his coat and left .	gary mengambil mantelnya dan pergi .
mommy has never seen mary dance .	ibu belum pernah melihat mary menari .
jack hasn t seen the video yet .	jack belum menonton videonya .
mommy is almost always cheerful .	ibu hampir selalu bahagia .
lim is an electrical engineer .	lim adalah seorang sarjana arus kuat .
daddy is disagreeable isn t he ?	ayah merasa terganggu bukan ?
vijay is playing the violin now .	vijay sedang bermain violin sekarang .
daddy is taller than his mother .	ayah lebih tinggi daripada ibunya .
john is very worried about you .	john sangat mengkhawatirkan kamu .
lim isn t quite himself today .	lim tidak seperti dirinya hari ini .
kim just wanted to be helpful .	kim hanya ingin mencoba membantu .
billy knew it was time to leave .	billy tahu ini saatnya untuk pergi .
jack looked down at the ground .	jack melihat ke arah tanah .
gary lost all the money he had .	gary kehilangan semua uangnya .
lee may change his mind later .	lee mungkin akan berubah pikiran nanti .
mommy may have known the answer .	ibu mungkin sudah mengetahui jawabannya .
billy moved out three weeks ago .	billy pindah keluar tiga minggu yang lalu .
maria must be found immediately .	maria harus ditemukan secepatnya .
mommy needs to follow my advice .	ibu butuh mengikuti saran saya .
vijay never brought anyone here .	vijay tidak pernah membawa siapa siapa kemari .
ken never even left the house .	ken tidak pernah sekalipun meninggalkan rumah .
lee paid no attention to mary .	lee tidak memperhatikan mary .
kim probably forgot it s here .	kim mungkin lupa ini di sini .
jack rolled his window back up .	jack menutup kaca jendelanya .
maria said he ll call you later .	maria berkata dia akan menghubungi kamu kembali .
billy saw mary break the window .	billy melihat mary memecahkan kaca jendela .
david should be back any second .	david seharusnya sudah kembali sekarang .
carrie sometimes comes home late .	carrie kadang kadang telat pulang ke rumah .
johnny tried to suppress a smile .	johnny berusaha menahan senyum .
mia s methods were unorthodox .	metode metode milik mia tidak lazim .
what if lee doesn t come back ?	bagaimana jika lee tidak kembali ?
why won t you talk to me mia ?	kenapa kamu tidak mau berbicara denganku mia ?
you know everything i do michael .	kamu tahu semua yang kulakukan michael .
did you tell kim mary did this ?	kamu memberitahu kim mary melakukan ini ?
even carrie is a little surprised .	bahkan carrie sedikit terkejut .
excuse me i m here to see darren .	permisi saya ingin bertemu dengan darren .
how long will daddy stay with us ?	berapa lama ayah akan tinggal bersama kami ?
i didn t want to humiliate daddy .	saya tidak ingin mempermalukan ayah .
i have a date with david tonight .	malam ini saya kencan dengan david .
i know what david is going to do .	aku tahu apa yang akan david lakukan .
i wonder what maria is doing now .	aku penasaran apa yang sedang dilakukan maria sekarang .
there was no one there but mommy .	di sana tidak ada orang selain ibu .
maria asked mary to quit her job .	maria meminta mary untuk berhenti bekerja .
billy asked mary to stop working .	billy meminta mary untuk berhenti bekerja .
daddy couldn t even look at mary .	ayah sampai tidak sanggup melihat ke arah mary .
billy couldn t find the bus stop .	billy tidak dapat menemukan tempat pemberhentian busnya .
ken doesn t feel like studying .	ken merasa seperti sedang tidak belajar .
mia doesn t like to be touched .	mia tidak suka disentuh .
ken grabbed the book from mary .	ken merebut buku itu dari mary .
david had a good opinion of mary .	david dulu memiliki anggapan yang baik tentang mary .
lee has been bitten by a snake .	lee telah digigit oleh seekor ular .
michael has been quite cooperative .	michael sudah cukup kooperatif sejauh ini .
gary is years older than mary .	gary tiga tahun lebih tua dari mary .
gary is on good terms with john .	gary berteman baik dengan john .
david knew he was being followed .	david tahu jika dia sedang diikuti .
david left boston a few days ago .	david meninggalkan boston beberapa hari lalu .
mommy likes to travel by himself .	ibu suka berkeliling sendiri .
ken might never trust me again .	ken mungkin tidak akan pernah mempercayaiku lagi .
michael might not want to see mary .	michael mungkin tidak ingin melihat mary .
lim narrowly escaped being hit .	lim hampir kena pukul .
billy prepared supper by himself .	billy menyiapkan makan malan sendiri .
lim really did a fantastic job .	lim sungguh telah melakukan pekerjaan yang luar biasa .
vijay regretted quitting his job .	vijay menyesal telah meninggalkan pekerjaannya .
darren resumed sweeping the floor .	darren melanjutkan menyapu lantai .
lee rode his bicycle to school .	lee mengendarai sepeda ke sekolah .
gary set the alarm on his watch .	gary mengatur pengingat pada jamnya .
john started clearing the table .	john mulai membersihkan meja .
carrie turned the doorknob slowly .	carrie memutar gagang pintu secara perlahan .
carrie walked toward the entrance .	carrie berjalan menuju pintu masuk .
kim wanted to go into politics .	kim ingin terjun ke dunia politik .
david wants me to take his place .	david ingin aku mengambil posisinya .
maria went shopping for dog food .	maria pergi membeli makanan anjing .
johnny went to boston to see mary .	johnny pergi ke boston untuk menemui mary .
billy went to school with my son .	billy pergi ke sekolah bersama dengan anak laki laki saya .
sarah works every day but sunday .	sarah bekerja setiap hari kecuali hari minggu .
kim s skull has been fractured .	tempurung kepala kim retak .
jack s speech quieted the crowd .	pidato jack membuat hadirin terdiam .
we re here to support you kim .	kami di sini untuk mendukungmu kim .
what did michael wear to the party ?	apa yang michael kenakan di pesta ?
call vijay and see what he thinks .	panggil vijay dan cari tahu apa pendapatnya .
didn t you and sarah ever do that ?	bukankah kamu dan sarah pernah melakukan hal itu ?
do you think darren is still alive ?	menurutmu darren masih hidup ?
do you think lim is still alive ?	apa menurutmu lim masih hidup ?
don t let daddy hear you say that .	jangan biarkan ayah mendengarkanmu mengatakan itu .
how do you feel about this sarah ?	apa yang kamu rasakan tentang ini sarah ?
how s it going with you and sarah ?	bagaimana hubunganmu dengan sarah ?
i am leaving for tokyo carrieorrow .	aku akan pergi ke tokyo besok .
i guess maria is looking for mary .	kurasa maria sedang mencari mary .
i said i d talk to billy about it .	aku bilang aku akan bicara pada billy tentang hal itu .
i told daddy we could do it today .	aku memberitahu ayah kalau kita bisa melakukannya hari ini .
i wonder what gary is doing here .	aku penasaran apa yang gary lakukan di sini .
i m glad you could make it ken .	aku bersyukur kamu dapat melakukannya ken .
i m going over to sarah s tonight .	aku akan pergi ke rumah sarah malam ini .
if anybody can fix it it s maria .	jika ada orang yang dapat memperbaikinya orang itu adalah maria .
that should get jack s attention .	itu pasti akan menarik perhatiannya jack .
john answered in the affirmative .	john menyetujuinya .
mia arrived three minutes early .	mia tiba tiga menit lebih awal .
mommy ate only one slice of bread .	ibu cuma makan satu potong roti .
ken didn t have to be so formal .	ken tidak perlu seformal itu .
kim enjoys playing tricks on me .	kim senang mengerjaiku .
daddy filled the glass with water .	ayah mengisi gelas dengan air .
john gladly accepted mary s gift .	john dengan senang hati menerima hadiah dari mary .
lim has shaved off his mustache .	lim telah mencukur kumisnya .
billy is a personal enemy of mine .	billy adalah musuh pribadi saya .
ken is alone in the living room .	ken berada seorang diri di ruang keluarga .
ken is getting ready for school .	ken bersiap pergi ke sekolah .
ken is hiding something from us .	ken menyembunyikan sesuatu dari kita .
nancy is much taller than you are .	nancy jauh lebih tinggi daripada kamu .
billy is quick tempered isn t he ?	billy gampang marah ya ?
carrie is the tallest in his class .	carrie adalah yang tertinggi di kelasnya .
maria is wearing a biohazard suit .	maria mengenakan baju biobahaya .
michael laid his cards on the table .	michael meletakkan kartu kartunya di atas meja .
billy left only a few minutes ago .	billy pergi beberapa menit yang lalu .
vijay moved here three months ago .	vijay pindah ke sini tiga bulan yang lalu .
ken never gave in to temptation .	ken tidak pernah menyerah pada godaan .
mommy offered mary a stick of gum .	ibu menawarkan sebatang permen kepada mary .
maria often cries when he s drunk .	maria seringkali menangis saat dia mabuk .
sarah practiced every day at home .	sarah berlatih setiap hari di rumah .
mia put on one of john s shirts .	mia mengenakan salah satu baju milik john .
michael realizes he s being ignored .	michael menyadari dirinya sedang dihiraukan .
jack received a letter from mary .	jack menerima surat dari mary .
kim seemed to be very surprised .	kim terlihat sangat terkejut .
michael seldom speaks to us anymore .	michael sudah jarang berbicara dengan kami .
lim slowly walked up the stairs .	lim menaiki tangga secara perlahan .
vijay sold his house for .	vijay menjual rumahnya .
nancy went to boston to meet mary .	nancy pergi ke boston untuk menemui mary .
we shouldn t have told johnny that .	mestinya kita tidak memberi tahu itu pada johnny .
what have you learned about jack ?	apa yang kamu ketahui tentang jack ?
you don t have to come kenorrow .	kamu tidak harus datang besok .
you don t have to come nancyorrow .	anda tidak harus datang besok .
do i have your word on that carrie ?	dapatkah saya mempercayai perkataanmu terhadap itu carrie ?
find sarah before he hurts someone .	temukan sarah sebelum ia menyakiti seseorang .
i don t care what lim looks like .	aku tidak peduli lim terlihat seperti apa .
i don t want to see carrie get hurt .	aku tidak mau melihat carrie tersakiti .
i know how much you meant to gary .	aku tahu seberapa berartinya dirimu bagi gary .
i see no need for michael to do that .	aku rasa michael tidak perlu melakukannya .
i ve got three hours to find johnny .	aku menghabiskan waktu jam untuk mencari johnny .
nancy appreciated mary s hard work .	nancy menghargai kerja keras mary .
carrie couldn t hide his excitement .	carrie tidak mampu menyembunyikan antusiasmenya .
daddy doesn t know what went wrong .	ayah tidak mengetahui apa yang salah .
lim had a car accident in boston .	lim mengalami kecelakaan mobil di boston .
kim hasn t arrived in boston yet .	kim masih belum tiba di boston .
darren is almost as tall as you are .	darren hampir sama tingginya dengan kamu .
david is interested in mathematics .	david tertarik pada matematika .
ken left without even telling me .	ken pergi tanpa memberitahuku .
mia likes making paper airplanes .	mia suka membuat pesawat kertas .
billy likes tea better than coffee .	billy lebih suka teh daripada kopi .
mommy likes to listen to mary sing .	ibu suka mendengar nyanyian mary .
mommy lives alone in a large house .	ibu tinggal sendiri di rumah yang besar
jack looks like he s seen a ghost .	jack nampak seperti telah melihat setan .
billy made me wait for three hours .	billy membuat saya menunggu selama tiga jam .
mommy may not be busy but mary is .	ibu mungkin tidak sibuk tetapi mary mungkin .
nancy might think i don t like him .	nancy mungkin berpikir bahwa aku tidak menyukainya .
johnny nudged the door open a crack .	johnny mendorong pintunya dan membukanya sedikit .
carrie often swears when he s angry .	carrie sering bersumpah serapa ketika marah .
carrie pointed to a spot on the map .	carrie menunjuk suatu tempat di peta .
lee probably won t become famous .	lee mungkin tidak akan pernah menjadi terkenal .
daddy realized mary wasn t kidding .	ayah menyadari mary tidak sedang bercanda .
billy says he can wait a long time .	billy berkata dia dapat menunggu lama .
billy screamed as loud as he could .	billy berteriak sekencang kencangnya .
david seems very angry doesn t he ?	david kelihatannya sangat marah ya ?
david slipped out of the classroom .	david menyelinap keluar kelas .
lim thanked everyone for waiting .	lim berterima kasih kepada semuanya karena telah menunggu .
david took charge of the situation .	david mengambil alih situasi .
ken tried to answer the question .	ken mencoba menjawab pertanyaan itu .
jack waited for mary to come home .	jack menunggu mary pulang ke rumah .
daddy wanted to wear his new shoes .	ayah ingin mengenakan sepatu barunya .
john was confused by the question .	john dibingungkan oleh pertanyaan itu .
billy was unable to hide his tears .	billy tidak kuasa menahan air matanya .
maria will be here in five minutes .	maria akan sampai di sini dalam lima menit .
ken s father is a police officer .	ayah ken adalah seorang polisi .
kim s parents were both teachers .	kedua orang tua kim adalah guru .
daddy s proposal wasn t acceptable .	lamaran ayah tidak diterima .
uncle david is my mother s brother .	paman david adalah adik ibuku .
wait until i tell ken about this .	tunggu sampai aku memberitahu ken tentang hal ini .
we re a little worried about john .	kami sedikit khawatir dengan john .
what happened wasn t ken s fault .	apa yang terjadi bukanlah kesalahan ken .
what happens if vijay doesn t pass ?	apa yang terjadi jika vijay tidak lulus ?
you and gary have a lot in common .	kamu dan gary punya banyak kesamaan .
you know what they say about billy .	kamu tahu apa yang mereka katakan tentang billy .
a cusmichaels declaration is required .	memerlukan pemberitahuan pabean .
both sarah and mary are from boston .	baik sarah dan mary keduanya berasal dari boston .
i always said maria was a smart kid .	aku selalu bilang kalau maria anak yang pandai .
i apologize for what john has done .	saya minta maaf atas apa yang telah diperbuat oleh john .
i know exactly what darren was doing .	aku tahu tepatnya apa yang darren lakukan .
i only told lee what mary told me .	aku hanya memberi tahu lee apa yang mary beritahu padaku .
i saw darren and mary leave together .	saya melihat darren dan mary berangkat bersama .
i think i know why carrie isn t here .	aku kira aku tahu kenapa carrie tidak ada di sini .
i thought lim and mary were happy .	aku kira lim dan mary bahagia .
i told johnny i didn t want his help .	saya beritahu johnny bahwa saya tidak butuh pertolongannya .
i wonder why sarah is staring at me .	aku penasaran kenapa sarah memandangiku .
i ve got to go to church jackorrow .	aku harus pergi ke gereja besok .
nobody pays much attention to vijay .	tidak ada orang yang cukup memperhatikan vijay .
someone told me john left his wife .	seseorang memberitahuku kalau john meninggalkan istrinya .
that hat looks really good on jack .	topi itu terlihat bagus dipakai oleh jack .
the meeting will be held sarahorrow .	rapatnya akan dilaksanakan besok .
maria and mary did what they had to .	maria dan mary melakukan apa yang harus mereka lakukan .
mommy asked mary to lower her voice .	ibu meminta mary untuk memelankan suaranya
nancy borrowed some money from mary .	nancy meminjam sedikit uang dari mary .
darren can t have done it by himself .	darren tidak mungkin melakukannya seorang diri .
daddy could do nothing to help mary .	ayah tidak dapat melakukan apapun untuk menolong mary .
michael decided to ignore the problem .	michael memutuskan untuk mengabaikan permasalahannya .
john didn t talk to mary all night .	john tidak mengajak bicara mary selama semalaman .
daddy eats more ice cream than i do .	ayah memakan lebih banyak es krim daripada aku .
nancy gave mary a box of chocolates .	nancy memberi mary sekotak coklat .
ken goes for a walk every morning .	ken pergi jalan jalan setiap pagi .
darren has arrived in boston already .	darren sudah sampai di boston .
jack has offered to walk mary home .	jack menawarkan mary untuk mengantarkannya pulang .
lee is playing catch with his son .	lee bermain lempar lemparan dengan anak laki lakinya .
david is quite successful isn t he ?	david lumayan berhasil ya ?
vijay is ugly but he s really nice .	vijay jelek tapi ia sangat baik .
michael just looked down at the floor .	michael hanya melihat ke arah lantai .
carrie likes to make paper airplanes .	carrie suka membuat pesawat kertas .
ken locked himself in his bedroom .	ken mengunci dirinya dalam kamar .
jack looks a bit tired doesn t he ?	bukankah jack terlihat sedikit lelah ?
carrie made an excuse for being late .	carrie membuat alasan atas keterlambatannya .
michael narrowly escaped being killed .	michael hampir saja terbunuh .
nancy needs all the help he can get .	nancy sangat membutuhkan bantuan .
daddy needs to change his lifestyle .	ayah perlu mengubah gaya hidupnya .
billy now knows mary wasn t kidding .	billy sekarang menyadari mary tidak sedang bercanda .
michael once owned this piece of land .	michael pernah memiliki sekompleks tanah ini .
lee pretended not to be listening .	lee berlaku seolah olah tidak mendengarkan .
mommy realized it was time to leave .	ibu menyadari sekarang adalah waktu untuk pergi .
darren really likes basketball a lot .	darren sangat menyukai bermain basket .
jack sat down and crossed his legs .	jack duduk dan menyilangkan kakinya .
gary should ve kept his mouth shut .	gary seharusnya menutup mulutnya rapat .
johnny slowly looked around the room .	johnny melihat sekitar ruangan secara perlahan .
lim started to descend the stairs .	lim mulai menuruni tangganya .
sarah visited australia last summer .	sarah mengunjungi australia musim panas kemarin .
sarah wants to be popular at school .	sarah ingin menjadi terkenal di sekolah .
michael wants us to improve ourselves .	michael ingin kita untuk memperbaiki diri kita .
carrie works every day except sunday .	carrie bekerja setiap hari kecuali hari minggu .
johnny i want to show you something .	johnny aku ingin menunjukkan sesuatu .
you shouldn t tell sarah everything .	kau tidak perlu memberi tahu sarah segalanya .
are you feeling all right now maria ?	apakah kamu baik baik saja maria ?
does kim know what to do with this ?	apakah kim mengetahui apa yang harus dilakukan dengan ini ?
how long were you and michael together ?	berapa lama kamu dan michael bersama ?
i am going to go to tokyo daddyorrow .	aku akan pergi ke tokyo besok .
i don t want to show it to ken yet .	aku masih belum mau menunjukkannya kepada ken .
i thought darren had gotten over mary .	aku pikir darren sudah lelah mengejar mary .
i told mommy i could do it by myself .	aku memberitahu ibu kalau aku bisa melakukannya sendiri .
if lim were older he d understand .	jika lim lebih dewasa dia akan mengerti .
no one was more surprised than darren .	tidak ada seorangpun yang lebih terkejut dari darren .
please give gary another chance ok ?	tolong beri gary kesempatan lain ok ?
this is what mia does for a living .	ini yang dilakukan mia untuk hidup .
daddy didn t know where he should go .	ayah tidak tahu tahu ke mana ia harus pergi .
ken doesn t think mary wants to go .	ken merasa mary tidak ingin pergi .
gary doesn t trust what anyone says .	gary tidak mau mempercayai apapun yang dikatakan orang lain .
johnny doesn t want mary to touch him .	johnny tidak ingin mary menyentuhnya .
lee doesn t want anything to drink .	lee tidak ingin minum apa apa .
vijay grudgingly did what mary asked .	vijay melakukan apa yang mary minta dengan berat hati .
lim has caused us a lot of trouble .	lim sudah menyusahkan kita semua .
maria has just come back from boston .	maria baru saja kembali dari boston .
lim hasn t said a word all evening .	lim tidak berkata sepatah kata pun sepanjang sore .
maria is exactly the same age as you .	maria itu seumuran dengan mu
johnny knows mary is hiding something .	johnny tahu mary menyembunyikan sesuatu .
gary lost his son in a car accident .	gary kehilangan anak laki lakinya akibat kecelakaan mobil .
ken might not know that we re here .	ken mungkin tidak tahu jika kita di sini .
john never goes to places like that .	john tidak pernah pergi ke tempat seperti itu .
darren obviously got what he came for .	darren secara jelas mendapatkan apa yang seharusnya dia dapat .
jack picked up the phone and dialed .	jack mengangkat teleponnya dan melakukan panggilan .
billy pleaded with mary not to leave .	billy memohon kepada mary untuk tidak pergi .
kim poured brandy into the glasses .	kim menuang brandy ke dalam gelas .
darren poured cold water over himself .	darren menyiramkan air dingin ke dirinya sendiri .
billy probably went out for some air .	billy mungkin pergi keluar untuk membeli air .
gary promised to keep it to himself .	gary berjanji menyimpannya untuk dirinya sendiri .
kim says he s cut down on drinking .	kim bilang dia mengurangi frekuensi minumnya .
michael says he s feeling better today .	michael berkata dia merasa lebih baik hari ini .
vijay scolded his son for being late .	vijay memarahi anak laki lakinya karena telah terlambat .
john scolded his son for being lazy .	john memarahi anak laki lakinya karena telah malas .
lim seems to understand what i say .	lim terlihat mengerti apa yang saya katakan .
mommy should arrive in a few minutes .	ibu akan tiba beberapa menit lagi .
gary should ve arrived by this time .	gary seharusnya sudah sampai sekarang .
david slammed the bathroom door shut .	david menutup pintu kamar mandi secara keras .
michael thought it was a good solution .	michael mengira itu adalah solusi yang baik .
we are giving david a birthday party .	kami akan berikan david pesta ulang tahun .
what exactly do you know about mia ?	tepatnya apa yang kamu ketahui tentang mia ?
are you interested in baseball sarah ?	sarah kamu tertarik dengan permainan bisbol ?
did you tell daddy that mary did this ?	kamu memberitahu ayah kalau mary melakukan ini ?
even maria was surprised to hear that .	bahkan maria terkejut mendengarkan itu .
i don t want jack to hear about this .	aku tidak ingin jack mendengar tentang hal ini .
i leave for london miaorrow morning .	besok pagi aku berangkat menuju london .
i thought you might want to see mia .	aku pikir kau perlu bertemu dengan mia .
the cusmarias office is at the border .	kantor bea dan cukai ada di perbatasan .
david arrived at home early yesterday .	david tiba di rumah lebih awal kemarin .
john came here to ask us to help him .	john datang kemari untuk meminta kami menolongnya .
johnny couldn t possibly have hit mary .	mana mungkin johnny memukul mary .
mia didn t meet mary or anyone else .	mia tidak bertemu dengan mary atau siapapun juga .
vijay doesn t like speaking in public .	vijay tidak suka berbicara di depan umum .
sarah eats lunch by himself every day .	sarah makan siang sendirian setiap hari .
johnny has difficulty making decisions .	johnny kesulitan dalam membuat keputusan .
gary is considering joining the army .	gary mempertimbangkan untuk bergabung dengan militer .
mia is interested in mountaineering .	mia tertarik pada pendakian gunung .
daddy is talking to mary on the phone .	ayah sedang berbicara dengan mary di telepon .
sarah kissed mary and she slapped him .	sarah mencium mary dan mary pun menamparnya .
carrie may talk to mary if he wants to .	carrie akan berbicara dengan mary jika dia ingin .
sarah motioned for mary to follow him .	sarah mengisyaratkan mary untuk mengikutinya .
david needs to lower his expectations .	david perlu menurunkan ekspektasinya .
mia nervously handed mary the knife .	mia secara gugup menyerahkan pisau kepada mary .
johnny never gives anything to anybody .	johnny tidak pernah memberikan apapun pada siapapun .
lim offered his seat to an old lady .	lim menawarkan kursinya kepada seorang nenek .
darren persuaded mary to join our band .	darren membujuk mary bergabung dengan band kami .
billy poured cold water over his head .	billy menuangkan air dingin ke kepalanya .
gary pretended that he didn t see it .	gary berlaku seolah olah tidak melihatnya .
daddy probably knows i don t like him .	ayah mungkin tahu aku tidak menyukainya .
darren promised to never be late again .	darren berjanji untuk tidak terlambat lagi .
daddy put the pencil down on the desk .	ayah meletakkan pensilnya di atas meja .
mommy really likes playing the guitar .	ibu sangat suka bermain gitar .
david said he wanted to be left alone .	david bilang dia ingin ditinggal sendiri .
sarah saw mary coming down the stairs .	sarah melihat mary datang menuruni tangga .
jack saw mary getting ready to leave .	jack melihat mary bersiap untuk pergi .
nancy saw mary heading into the woods .	nancy melihat mary pergi ke hutan .
john seems to be looking for someone .	john terlihat seperti sedang mencari seseorang .
darren stirred his coffee with a spoon .	darren mengaduk kopinya dengan sebuah sendok .
where are nancy and his family living ?	dimana nancy dan keluarganya tinggal ?
did ken say how he was able to do it ?	apa ken mengatakan bagaimana ia bisa melakukannya ?
did you and mommy ever talk about that ?	apakah kamu dan ibu pernah membicarakan hal itu ?
do you know what maria was doing there ?	apakah kamu tahu apa yang maria lakukan di sini ?
i have no idea what carrie said to mary .	aku tidak tahu apa yang carrie katakan pada mary .
i m afraid jack won t be able to come .	aku rasa jack tidak akan bisa datang .
if you were gary what would you want ?	kalau saja kau adalah gary apa yang kau inginkan ?
school begins the day after miaorrow .	kegiatan sekolah akan dimulai besok lusa .
billy asked if he needed to wear a tie .	billy bertanya apakah ia perlu mengenakan dasi .
darren carefully read over the contract .	darren membaca kontrak itu dengan hati hati .
darren didn t think he could trust mary .	darren tidak yakin kalau dia bisa mempercayai mary .
nancy doesn t know how much it ll cost .	nancy tidak tahu berapa biayanya .
john doesn t know how to speak french .	john tidak tahu cara berbicara bahasa perancis .
john grows all the vegetables he eats .	john menanam sendiri semua sayuran yang ia makan .
mia has been very unlucky hasn t he ?	mia benar benar kurang beruntung ya ?
nancy is leaving kobe nancyorrow morning .	nancy akan meninggalkan kobe besok pagi .
ken is still not answering his phone .	ken masih tidak mengangkat teleponnya .
mia is the newest member of our team .	mia anggota terbaru tim kami .
maria is the newest member of our team .	maria anggota terbaru tim kita .
mia left about an hour ago with mary .	mia pergi sejam yang lalu dengan mary
darren left to meet you three hours ago .	darren pergi untuk menemuimu tiga jam yang lalu .
lee managed to swim across the river .	lee berhasil berenang menyeberangi sungai .
ken pointed to the chair next to his .	ken menunjuk kursi disebelahnya .
darren probably just forgot you re here .	darren mungkin saja lupa kamu di sini .
kim sat at his desk reading a report .	kim duduk membaca laporan di mejanya .
michael saw mary s name on the list too .	michael juga melihat nama mary di daftar .
nancy says he s trying to quit smoking .	nancy berkata dia sedang berusaha berhenti merokok .
vijay shouldn t have said those things .	vijay tidak seharusnya mengucapkan perkataan itu .
billy spends a lot of his time reading .	billy banyak menghabiskan waktunya dengan membaca .
darren thought mary seemed really happy .	darren mengira mary terlihat sangat senang .
mia walked in through the front door .	mia melangkah masuk melalui pintu depan .
we should ve known jack would be late .	kita seharusnya tahu kalau jack akan terlambat .
you d better tell maria not to do that .	kamu sebaiknya memberitahu maria untuk tidak melakukannya .
i can t imagine why david would do that .	aku tidak bisa membayangkan kenapa david harus melakukan itu .
i don t think i ll ever see mia again .	aku pikir aku tidak akan pernah bertemu mia lagi .
i thought mommy would say hello to mary .	ku pikir ibu akan menyapa mary tadi .
i ll be back by davidorrow if possible .	kalau memungkinkan saya akan kembali besok .
ken always tries to help other people .	ken selalu mencoba membantu orang lain .
jack didn t realize what was happening .	jack tidak menyadari apa yang sedang terjadi tadi .
david doesn t know much about indonesia .	david tidak tahu banyak tentang indonesia .
billy hardly ever speaks french anymore .	billy sudah jarang berbicara dalam bahasa prancis .
nancy lives in the apartment above mary .	nancy tinggal di apartemen diatas tempat mary .
maria looks as though he s seen a ghost .	maria nampak seperti telah melihat hantu .
mia made no attempt to defend himself .	mia tidak berusaha melindungi dirinya sendiri .
sarah made the right decision after all .	pada akhirnya sarah membuat keputusan yang tepat .
mommy must ve found out that i was here .	ibu pasti tahu jika aku pernah di sini .
gary needs to lose three or four kilos .	gary perlu menurunkan berat badan tiga atau empat kilo .
michael poked his pencil through the hole .	michael mencucukkan pensilnya kedalam lubang .
kim realized mary was waiting for him .	kim menyadari mary menunggu dirinya .
mommy really likes swimming doesn t he ?	bukankah ibu sungguh menyukai berenang ?
david said he d never speak to me again .	david berkata dia tidak akan pernah berbicara denganku lagi .
vijay saw a boy waiting at the bus stop .	vijay melihat seorang anak laki laki menunggu di halte .
ken took aim and fired a warning shot .	ken membidik dan menembakkan tembakan peringatan .
maria tried to push mary into the water .	maria mencoba mendorong mary kedalam air .
ken understands what needs to be done .	ken paham apa yang harus dituntaskan .
ken was unable to hide his excitement .	ken tidak mampu menyembunyikan antusiasmenya .
lim wasn t injured in the train wreck .	lim tidak terluka dalam kecelakaan kereta itu .
darren mary and john are in the kitchen .	darren mary dan john sedang berada di dapur .
we don t even know how to contact lim .	kita bahkan tidak tahu cara menghubungi lim .
are you spending thanksgiving with john ?	apa kamu menghabiskan waktu bersama john di hari thanksgiving ?
could i speak to you for a moment vijay ?	dapatkah saya berbicara denganmu sebentar vijay ?
did lee say anything to you about that ?	apakah lee mengatakan sesuatu kepadamu tentang hal itu ?
do you remember the night maria was born ?	apa kau ingat malam ketika maria lahir ?
do you think mommy looks like an old man ?	apa menurutmu ibu terlihat seperti orang tua ?
i do not know if it will rain mariaorrow .	aku tidak tahu apakah besok akan hujan .
i suppose we should tell lim the truth .	aku pikir kita harus memberitahu lim yang sebenarnya .
i was thinking about daddy earlier today .	aku memikirkan tentang ayah beberapa saat yang lalu .
i wish carrie hadn t told mary about that .	aku harap carrie belum memberitahukan hal itu kepada mary .
let s leave the problem until johnorrow .	mari kita tunda masalah itu hingga besok .
look sarah we don t have time for this .	sudahlah sarah kita tidak punya waktu untuk hal ini .
daddy admitted that he had been defeated .	ayah tadi mengakui kekalahannya
johnny always wears goggles when he swims .	johnny selalu mengenakan kacamata ketika dia berenang .
carrie currently teaches english in japan .	carrie sekarang mengajar bahasa inggris di jepang .
john decided to run for class president .	john memutuskan untuk mencalonkan diri sebagai ketua kelas .
darren didn t notice how mary was dressed .	darren tidak tahu bagaimana mary berpakaian .
ken didn t understand mary s reasoning .	ken tidak memahami pertimbangan mary .
johnny has a small cabin on the lakefront .	johnny memiliki sebuah pondok kecil di depan danau .
lee is preparing dinner in the kitchen .	lee mempersiapkan makan malam di dapur .
carrie is sitting at the table over there .	carrie duduk di meja sebelah sana .
nancy is still in kindergarten isn t he ?	nancy masih tk kan ?
darren is three years older than his wife .	darren lebih tua tiga tahun dari istrinya .
johnny isn t any busier than anybody else .	johnny tidak lebih sibuk dari siapa pun .
david knew that mary needed to buy a car .	david tahu kalau mary perlu membeli mobil .
lim knows that mary can t speak french .	lim tahu bahwa mary tidak bisa berbicara bahasa prancis .
maria shivered when he saw the black cat .	maria merinding ketika ia melihat kucing hitam itu .
jack showed mary how to sharpen a knife .	jack menunjukkan mary bagaimana cara mengasah pisau .
darren showed up early for practice today .	darren datang lebih awal untuk berlatih hari ini .
vijay suggested ways we could save money .	vijay menyarankan cara cara agar kita dapat menghemat uang .
gary told me he likes going to concerts .	gary bilang ke aku kalau dia suka pergi nonton konser .
lee tossed the soda can into the trash .	lee melempar kaleng sodanya ke dalam tong sampah .
john tried to persuade mary to help him .	john mencoba membujuk mary untuk membantunya .
billy waited on the front porch for mary .	billy menunggu mary di beranda depan .
michael wanted another piece of watermelon .	michael mau sepotong semangka lagi .
you can t leave me here alone with john .	kau tidak bisa meninggalkanku di sini sendirian dengan john .
all daddy wanted was some peace and quiet .	yang ayah inginkan adalah kedamaian dan ketenangan .
how long have you and johnny been together ?	sudah berapa lama kamu dan johnny bersama ?
i don t want mia singing at our wedding .	aku tidak mau mia bernyanyi di pernikahan kita .
i thought that darren was going to kill me .	aku pikir tadi darren ingin membunuhku .
i thought you might know where kim went .	kupikir kamu tahu kemana kim pergi .
i told jack i thought it was a good idea .	aku berkata pada jack bahwa aku pikir itu adalah ide yang bagus .
i d like to thank david for all he s done .	aku ingin berterima kasih kepada david atas apa yang ia lakukan .
i m very pleased with jack s performance .	saya sangat puas dengan penampilan jack .
mary doesn t like men who look like john .	mary tidak menyukai pria yang terlihat seperti john .
there was nothing really wrong with mia .	sama sekali tidak ada yang salah dengan mia .
michael and mary played tennis all day long .	michael dan mary bermain tenis seharian .
ken and mary were talking to each other .	ken dan mary saling berbicara .
billy asked for permission to leave early .	billy meminta izin untuk pulang lebih awal .
johnny didn t find what he was looking for .	johnny tidak menemukan apa yang sedang ia cari .
michael doesn t need to go there by himself .	michael tidak perlu pergi ke sana sendirian .
jack had no food or water for three days .	jack tidak makan dan minum selama tiga hari .
johnny has been there for over three years .	johnny sudah berada di sana selama lebih dari tiga tahun .
michael has never lived anywhere but boston .	michael tidak pernah tinggal di tempat lain selain boston .
darren has two brothers who live in boston .	darren punya dua saudara lelaki yang tinggal di boston .
sarah looks as if he lost his best friend .	sarah nampak seperti telah kehilangan teman baiknya .
daddy picked the box up and looked inside .	ayah mengangkat kotak dan melihat isinya .
lee picked up the knife and examined it .	lee mengambil pisau dan memeriksanya .
mommy pushed the wheelchair down the hall .	ibu mendorong kursi roda melewati lorong .
lim stood up and walked out of the room .	lim berdiri dan berjalan keluar ruangan .
vijay wants to be the center of attention .	vijay ingin menjadi pusat perhatian .
jack went splashing through the shallows .	jack pergi melewati sungai yang dangkal dengan berjalan kaki .
sarah won t do that unless you ask him to .	sarah tidak akan melakukannya kecuali jika kau memintanya .
does gary know how much you paid for that ?	apakah gary tahu berapa banyak yang kamu keluarkan untuk itu ?
i didn t expect john to be at the meeting .	aku tidak menyangka john hadir dalam rapat .
i heard that sarah plans to move to boston .	saya mendengar bahwa sarah berencana pindah ke boston .
i just assumed mary was johnny s girlfriend .	saya beranggapan bahwa mary adalah pacarnya johnny
i think i can help gary with his homework .	aku pikir aku bisa membantu gary mengerjakan prnya .
i think i know why michael doesn t like mary .	aku pikir aku tahu kenapa michael tidak suka pada mary .
i d like to show ken what i bought today .	saya ingin menunjukkan ken apa yang kubawa hari ini .
i m pretty impressed with john s progress .	aku sangat terkesan dengan perkembangan john .
is it true that maria doesn t like to swim ?	apakah benar maria tidak suka berenang ?
the cuslees officials examined the boxes .	petugas bea dan cukai memeriksa kotak kotak .
sarah and mary both turned around to watch .	sarah dan mary keduanya berbalik untuk melihat .
john asked mary to go to a movie with him .	john mengajak mary pergi menonton film bersamanya .
jack bought the cheapest one in the store .	jack membeli yang termurah dari toko itu .
darren could tell that mary wanted to leave .	darren dapat mengatakan bahwa mary ingin pergi .
sarah didn t know because i never told him .	sarah tidak tahu karena aku tidak pernah memberitahunya .
darren didn t think you would like the idea .	darren tidak yakin kau akan suka dengan ide itu .
gary doesn t watch tv except on saturdays .	gary tidak menonton tv kecuali hari sabtu .
sarah has decided not to stay until monday .	sarah memutuskan untuk tidak menginap sampai hari senin .
vijay knew something went wrong didn t he ?	vijay tahu ada yang salah iya kan ?
kim knows exactly what this is all about .	kim tahu persis apa yang ada dibalik semua ini .
mommy pulled the door closed and locked it .	ibu menarik pintu hingga tertutup dan menguncinya .
gary raised the three children by himself .	gary mengasuh tiga anak sendirian .
michael really knows how to cook doesn t he ?	bukankah michael sungguh tahu cara memasak ?
gary recommended that i apply for the job .	gary merekomendasikan saya untuk melamar pekerjaan .
mia said doing that would be a good idea .	mia bilang hal itu merupakan ide bagus
sarah said that he wanted to be left alone .	sarah berkata kalau dia ingin menyendiri .
billy says he doesn t want to study french .	billy bilang dia tidak ingin belajar bahasa perancis .
carrie seemed to be worried about something .	carrie terlihat mengkhawatirkan sesuatu .
michael showed up at john and mary s wedding .	michael hadir pada pernikahan john dan mary .
darren spends way too much time goofing off .	darren terlalu banyak menyia nyiakan waktu .
mommy wanted mary to go to boston with him .	ibu ingin mary pergi ke boston bersamanya .
david was the first guy who broke my heart .	david laki laki pertama yang membuatku patah hati .
we have more cusbillyers than we can count .	kami punya banyak pelanggan dari yang mampu kami hitung .
we have to stay here until sarah gets back .	kita harus tetap di sini sampai sarah kembali .
why do you think it was nancy who did that ?	mengapa kamu mengira bahwa nancy yang melakukannya ?
does carrie really expect me to believe that ?	benarkah carrie menyangka saya akan mempercayai itu ?
don t you think darren looks like an old man ?	apa menurutmu darren tidak terlihat seperti orang tua ?
i can t believe that vijay is a grandfather .	saya tidak bisa percaya bahwa vijay adalah seorang kakek .
i think you should talk to nancy about this .	saya rasa kamu harus berbicara dengan nancy tentang hal ini .
i m counting on you to keep an eye on david .	aku mengandalkanmu untuk mengawasi david .
the only language nancy can speak is french .	satu satunya bahasa yang bisa nancy gunakan adalah bahasa prancis .
john and i used to work together in boston .	john dan aku dulu bekerja bersama di boston .
mia could see mary was about ready to cry .	mia melihat mary ingin menangis .
jack doesn t know when mary will come back .	jack tidak tahu kapan mary akan kembali .
maria fell down the stairs and hit his head .	maria jatuh dari tangga dan kepalanya terbentur .
johnny has been in trouble many times before .	johnny sudah seringkali mendapat masalah sebelumnya .
gary is alone in the dining room with mary .	gary berada seorang diri di ruang dapur bersama mary .
michael is going to wait until mary gets here .	michael akan menunggu hingga mary tiba .
mommy makes a lot more money than mary does .	ibu menghasilkan lebih banyak uang ketimbang mary .
johnny massages his temples with his fingers .	johnny memijat pelipisnya dengan jarinya .
maria picked up a rock and threw it at mary .	maria mengambil batu dan melemparkannya pada mary .
lee promised me he wouldn t do that again .	lee berjanji padaku bahwa dia tidak akan melakukan hal itu lagi .
maria received a fax from mary this morning .	maria menerima sebuah faks dari mary pagi ini .
michael retired from the army three years ago .	michael pensiun dari dinas tentara tiga tahun yang lalu .
sarah used to come to visit us every summer .	sarah biasanya datang mengunjungi kami setiap musim panas .
nancy would never forgive us if we did that .	nancy tidak akan pernah memaafkan kita jika kita melakukan itu .
darren s mouth was taped shut with duct tape .	mulut darren diplester dengan lakban .
why would you want talk to kim about that ?	kenapa kau ingin membicarakan hal itu dengan kim ?
you could go bowling with johnny if you want .	kau bisa pergi bermain boling dengan johnny kalau kau mau .
do you know the real reason michael isn t here ?	apa kamu tahu alasan sebenarnya mengapa michael tidak berada di sini ?
he dates the cusjohn from the colonial days .	dia memperkirakan bahwa adat kebiasaan itu telah dimulai sejak jaman kolonial .
how did you know billy was going to be fired ?	bagaimana kamu tahu kalau billy akan dipecat ?
i need carrie to do a couple of things for me .	aku perlu carrie melakukan beberapa hal untukku .
it was david that broke the window yesterday .	yang memecahkan kaca kemarin adalah david .
darren and mary have recently moved to boston .	darren dan mary pindah ke boston baru baru ini .
mia burned his fingers on a hot frying pan .	jari mia terbakar setelah tidak sengaja menyentuh wajan penggorengan yang panas .
mommy could tell that mary was pretty scared .	ibu dapat mengatakan bahwa mary cukup ketakutan .
ken didn t know what mary thought about it .	ken tidak tahu apa yang mary pikirkan tentang hal itu .
daddy doesn t get invited to parties anymore .	ayah tidak lagi diundang ke pesta .
billy doesn t seem to be having any problems .	billy tidak terlihat memiliki masalah .
lim doesn t think this is such a good idea .	lim merasa ini bukan ide yang baik .
lim has never lived anywhere except boston .	lim tidak pernah tinggal di tempat lain selain boston .
maria hasn t had a fight with anybody lately .	maria tidak berkelahi dengan siapa pun akhir akhir ini .
vijay loved mary who didn t love him at all .	vijay mencintai mary yang tidak mencintainya sama sekali .
sarah made good use of the money we lent him .	sarah menggunakan uang pinjaman kita dengan baik .
david never told anybody about what happened .	david tidak pernah memberitahu siapapun tentang apa yang terjadi .
jack never would ve dated someone like mary .	jack tidak akan pernah berkencan dengan seseorang seperti mary .
lee picked the diamond up and looked at it .	lee mengambil intan dan mengamatinya .
lim read mary s letter over and over again .	lim membaca surat mary berulang kali .
gary turned off the light and went to sleep .	gary mematikan lampu dan pergi tidur .
johnny was standing at the foot of the stairs .	johnny berdiri di atas anak tangga .
we are going to cycle to the lake johnnyorrow .	kami akan bersepeda ke danau besok .
i forgot jack knew how to play the accordion .	aku lupa kalau jack tahu cara memainkan akordion .
i think i mistakenly sent that email to gary .	saya rasa saya telah salah mengirim surel itu ke gary .
i d like to show this picture of mia to you .	aku ingin menunjukkan foto mia ini kepadamu .
nancy barely avoided crashing into mary s car .	nancy nyaris menabrak mobil mary .
kim doesn t know anything about mary s plan .	kim tidak mengetahui apapun tentang rencana mary .
mommy doesn t play golf as much as he used to .	ibu tidak lagi sering bermain golf seperti dulu .
billy is still being questioned by the police .	saat ini billy masih dimintai kesaksian oleh polisi .
mia isn t as good a golfer as he says he is .	mia bukan pemain golf yang baik sebaik yang ia katakan .
kim just stood there watching everybody eat .	kim berdiri di sana sambil melihat semua orang makan .
john promised not to go out after dark alone .	john berjanji untuk tidak pergi keluar tengah malam sendirian .
nancy said he didn t know why mary was absent .	nancy bilang dia tidak tahu kenapa mary absen .
vijay wants to know when we re going to leave .	vijay ingin tahu kapan kita akan berangkat .
billy was badly injured in a traffic accident .	billy terluka parah saat kecelakaan lalu lintas .
vijay works for a large financial institution .	vijay bekerja untuk sebuah lembaga keuangan yang besar .
daddy s eyes are red and he looks very tired .	mata ayah merah dan ia terlihat sangat lelah .
carrie s situation is getting more complicated .	situasi carrie menjadi semakin sulit .
why did you let jack go to boston by himself ?	kenapa kamu membiarkan jack pergi ke boston sendirian ?
do you really think that was what billy wanted ?	apa kamu benar benar berpikir kalau itu adalah apa yang billy inginkan ?
i don t think mia will be at school miaorrow .	aku tidak berpikir kalau mia akan ada di sekolah besok .
i gave david a direct order but he ignored it .	aku memberi david perintah langsung tapi dia tidak mengacuhkannya .
i m already accusjacked to the heat of summer .	aku sudah terbiasa dengan panasnya musim panas .
please fill out the cuslees declaration form .	silakan isi pemberitahuan pabean .
mommy broke mary s expensive chinese ming vase .	ibu memecahkan vas ming dari cina milik mary yang mahal
gary has lived in boston for most of his life .	gary sebagian besar hidupnya tinggal di boston
john is always telling mary that he loves her .	john selalu meyakinkan mary bahwa dia benar benar mencintainya
carrie is the only one who didn t pass the test .	carrie adalah satu satunya orang yang tidak lulus ujian .
carrie married a girl much younger than himself .	carrie menikahi perempuan yang lebih mudah dari dirinya .
jack probably already knows that mary is here .	jack kemungkinan sudah tahu kalau mary di sini .
lim told me he thought i was wasting my time .	lim bilang padaku kalau dirinya berpikir aku membuang buang waktu .
mia wanted save up enough money to buy a car .	mia ingin menyisihkan uangnya hingga cukup untuk membeli sebuah mobil .
mia was arrested on drug trafficking charges .	mia ditahan atas tuduhan perdagangan narkoba .
daddy was late for class as is often the case .	seperti biasa ayah terlambat datang ke kelas .
vijay was surprised that mary had a motorcycle .	vijay terkejut mengetahui mary memiliki sepeda motor .
kim wondered if mary could understand french .	kim ingin tahu apakah mary bisa memahami bahasa prancis .
lee s japanese is improving little by little .	kemampuan bahasa jepang lee meningkat sedikit demi sedikit .
sarah s gym teacher is mary s basketball coach .	guru senam sarah adalah pelatih basket mary .
i just assumed that mary was johnny s girlfriend .	saya beranggapan bahwa mary adalah pacarnya johnny
i want to find out if michael was at school today .	aku mau mencari tahu apakah michael ada di sekolah hari ini .
if john was angry before he ll be furious now .	jika sebelumnya john marah dia akan menjadi sangat marah sekarang ini .
ken accepts that what mary said was the truth .	ken menerima bahwa apa yang dikatakan mary adalah kenyataan .
kim asked mary if she wanted to go for a walk .	kim bertanya pada mary apa ia ingin jalan jalan .
billy eats everything that his mother gives him .	billy memakan semua yang ibunya berikan padanya .
david had a little trouble finding mary s house .	david sedikit kesulitan untuk menemukan rumah mary .
sarah has a friend whose father is an astronaut .	sarah punya teman yang ayahnya seorang astronot .
gary has been with our company for three years .	gary telah bekerja di perusahaan kami selama tiga tahun .
billy is too old to be doing this kind of thing .	billy terlalu tua untuk melakukan hal semacam ini .
kim probably doesn t know mary s phone number .	kim kemungkinan tidak tahu nomor telepon mary .
gary wanted to spend some time alone with mary .	gary ingin menghabiskan sedikit waktu berdua dengan mary .
you know daddy is a friend of mary s don t you ?	kamu tahu kalau ayah itu temannya mary kan ?
could i ask you to wait until johnnyorrow morning ?	bisakah saya meminta anda untuk menunggu hingga besok pagi ?
do you have any idea why michael doesn t like mary ?	apa kau tahu kenapa michael tidak suka dengan mary ?
how many times have you played tennis with john ?	sudah berapa kali kamu bermain tenis bersama john ?
i wonder if nancy still remembers how to do that .	saya berandai andai apakah nancy masih mengingat bagaimana cara untuk melakukannya .
daddy and mary have been dating for three months .	ayah dan mary telah berkencan selama tiga bulan .
lee and mary were standing close to each other .	lee dan mary berdiri berdekatan satu sama lain .
darren certainly isn t the genius he thinks he is .	darren tidaklah sejenius yang dia pikirkan .
we know carrie will do whatever we tell him to do .	kami tahu carrie akan melakukan apa saja yang kami perintahkan .
a cusgarys official asked me to open my suitcase .	petugas bea dan cukai meminta saya untuk membuka koper saya .
do you know the real reason that gary isn t here ?	apa kamu tahu alasan sebenarnya mengapa gary tidak berada di sini ?
i was able to do it with a little help from mommy .	aku bisa melakukannya dengan sedikit bantuan dari ibu .
i will be working on my report all day mommyorrow .	besok aku akan mengerjakan laporanku seharian .
if david had seen anything he would have told us .	jika david melihat sesuatu dia pasti sudah memberitahu kita .
if anybody could convince lim it would be mary .	marylah satu satunya yang dapat membujuk lim .
let s see if lee can manage to do it by himself .	mari kita lihat apakah lee bisa mengurusnya sendiri atau tidak .
sarah asked mary to teach him how to do the waltz .	sarah meminta mary untuk mengajarinya bagaimana caranya berdansa wals .
david is much more relaxed when mary isn t around .	david jauh lebih santai ketika mary tidak ada .
lim lowered his voice so no one else could hear .	lim mengecilkan suaranya sehingga tidak ada orang yang dapat mendengarnya .
nancy promised me he d never come back here again .	nancy berjani padaku bahwa dia tidak akan pernah kembali kemari lagi .
we re not entirely sure why mommy did what he did .	kami tidak mengerti kenapa ibu melakukan apa yang dilakukannya .
i assume that nancy doesn t have that many friends .	aku kira nancy tidak memiliki teman sebanyak itu .
it s necessary to go through cuskens on arriving .	kita wajib melalui pemeriksaan bea dan cukai saat kedatangan .
my uncle died of cancer of the smommyach yesterday .	kemarin pamanku meninggal karena kanker perut yang dideritanya .
mommy didn t want to make the same mistake as mary .	ibu tidak ingin membuat kesalahan yang sama seperti mary .
john has attempted to escape at least three times .	john telah melakukan sedikitnya tiga kali usaha untuk melarikan diri .
david likes the same kind of stuff that mary likes .	david menyukai jenis barang yang sama dengan yang mary suka .
gary seems to have changed his mind about staying .	gary sepertinya tidak lagi berniat untuk tinggal .
lim told mary that he didn t have to do anything .	lim memberitahu mary bahwa dia tidak ingin melakukan apapun .
lim woke up the next day with a painful hangover .	keesokan harinya lim bangun dengan sakit kepala yang sangat .
lee wrote me more than thirty messages yesterday .	lee mengirimiku tiga puluh lebih pesan kemarin .
you don t want johnny to think you re crazy do you ?	kau tidak ingin johnny berpikir kalau kau gila kan ?
vijay has to meet mary in the park vijayorrow at .	vijay harus bertemu mary besok di taman pada pukul .
kim made it clear that he didn t want to see mary .	kim mempertegas bahwa dia tidak ingin bertemu dengan mary .
mommy played baseball after school with his friends .	ibu bermain kasti dengan teman temannya setelah selesai sekolah .
we realize now that kim knew exactly who mary was .	kami akhirnya menyadari bahwa kim telah mengetahui siapa mary sebenarnya .
i m convinced that billy isn t telling us everything .	saya yakin billy tidak menceritakan semuanya pada kita .
the interview is scheduled for a .m . carrieorrow .	wawancara telah dijadwalkan pada jam pagi besok .
sarah boarded the ship along with his three children .	sarah menaiki kapal itu bersama ketiga anaknya .
david decided to upload the video he took to youtube .	david memutuskan untuk mengunggah video yang diambilnya ke youtube .
nancy didn t seem to understand what you were saying .	nancy sepertinya nggak ngerti kamu ngomong apa .
lee doesn t know what mary wants to eat for dinner .	lee tidak tahu apa yang mary inginkan untuk makan malam .
michael has lots of acquaintances but very few friends .	michael kenalannya banyak tapi temannya sedikit .
nancy posted a lewd photo of himself on social media .	nancy mengepos foto tidak senonohnya di media sosial .
do you know where lim has been the past three weeks ?	apa kau tahu di mana lim berada tiga minggu belakangan ini ?
i heard that johnny s boss refused to give him a raise .	aku dengar bos johnny menolak memberinya kenaikan gaji .
if lim doesn t mind i d like to join him for lunch .	kalau lim tidak keberatan saya ingin makan siang bersamanya .
lee bought a camera to give to mary on her birthday .	lee membeli sebuah kamera untuk diberikan kepada mary pada hari ulang tahunnya .
lim earns more money in an hour than i do in a week .	lim menghasilkan lebih banyak uang dalam jam dibandingkan apa yang saya hasilkan dalam minggu .
kim is a gang member . you should stay away from him .	kim itu anggota geng . kamu harus menjauhinya .
gary often has trouble choosing what clothes to wear .	gary seringkali bingung dengan pakaian yang akan ia kenakan .
sarah picked up john s briefcase and handed it to him .	sarah mengambil tas milik john dan menyerahkannya kepada john .
john probably doesn t even know why i don t like him .	john mungkin tidak akan pernah tahu mengapa aku tidak menyukainya .
johnny started playing the violin when he was thirteen .	johnny mulai bermain biola ketika dia berumur tigabelas tahun .
sarah was the one who planted the roses in our garden .	sarah adalah orang yang menanam mawar di kebun kita .
i met billy just the other day in front of the station .	waktu lalu saya bertemu billy di depan stasiun .
i wish girls found me as attractive as they find david .	aku harap para perempuan menganggapku tampan seperti david .
michael and mary have been married for about three years .	michael dan mary telah menikah selama kurang lebih tahun .
lee died of rabies after having been bitten by a bat .	lee meninggal akibat rabies setelah tergigit kelelawar .
maria has been putting aside a little money each month .	maria menyisihkan sebagian uangnya tiap bulan .
billy said that he thought mary didn t enjoy the movie .	billy bilang kalau dia mengira mary tidak menikmati filmnya .
i suspect that lim doesn t do his homework by himself .	aku menduga kalau lim tidak mengerjakan prnya sendiri .
i was searched by the cusnancys officers at the airport .	saya diperiksa badan oleh petugas bea dan cukai di bandar udara .
i ve lost my fountain pen . i have to buy one jackorrow .	aku kehilangan penaku . aku harus membeli satu lagi besok .
kim continued to study french for another three years .	kim melanjutkan mempelajari bahasa prancis hingga tiga tahun ke depan .
lim grew to love the stray dog that followed him home .	lim mulai menyukai anjing liar yang mngikutinya sampai ke rumah .
ken has to go shopping with his mother this afternoon .	ken harus pergi berbelanja dengan ibunya siang ini .
sarah noticed mary s car parked in front of the library .	sarah menyadari mobil mary yang diparkir di depan perpustakaan .
ken put off his wedding because of a traffic accident .	ken membatalkan pernikahannya karena kecelakaan lalu lintas .
lee squatted down to put something on the lower shelf .	lee berjongkok untuk menaruh sesuatu di rak bawah .
mia tried his best to get here but he didn t make it .	mia berusaha sekeras mungkin untuk bisa sampai ke sini tapi dia tidak berhasil .
 johnny likes mary . i think that s obvious to everyone . 	 johnny suka pada mary . aku pikir itu sudah jelas bagi semuanya . 
i m supposed to meet jack in boston next monday at .	saya seharusnya bertemu jack di boston senin depan pada .
maybe that s what darren would do but i wouldn t do that .	mungkin itu apa yang darren akan lakukan tetapi saya tidak mungkin pernah melakukan hal itu .
mommy accepted mary s invitation to have dinner with her .	ibu menerima undangan mary untuk makan malam bersamanya .
sarah certainly wasn t at home when we went to visit him .	sarah benar benar tidak ada di rumah saat kami datang mengunjunginya .
david hasn t slept at all since the day before yesterday .	david belum tidur sama sekali sejak kemarin lusa .
john read the note from mary and then handed it to john .	john membaca catatan dari mary dan menyerahkannya kepada john .
david tried to convince mary that the plan wouldn t work .	david mencoba meyakinkan mary bahwa rencana itu tidak akan berhasil .
ken wondered what could have made mary change her mind .	ken penasaran akan apa yang telah membuat mary berubah pikiran .
you have to unpack your luggage for cuskens inspection .	anda harus membuka barang bawaan anda untuk pemeriksaan pabean .
as far as i know kim has never tried to commit suicide .	sejauh yang saya tahu kim tidak pernah mencoba membunuh diri .
cusvijays officials carried out a full body search on vijay .	petugas bea dan cukai melakukan pemeriksaan badan terhadap vijay .
the weather report says it will rain darrenorrow afternoon .	menurut ramalan cuaca besok siang akan turun hujan .
do you know why sarah wasn t at the meeting this afternoon ?	apa kamu tahu kenapa sarah tidak hadir pada rapat tadi siang ?
i wish i could figure out how to convince daddy to help us .	aku harap aku dapat menemukan cara untuk membuat ayah membantu kami .
johnny has always been a very easy person to get along with .	sangat mudah untuk bergaul dengan johnny .
kim is the only one on this island that can speak french .	kim satu satunya yang bisa berbahasa prancis di pulau ini .
michael married mary s sister and mary married michael s brother .	michael menikahi adiknya mary dan mary menikahi kakaknya michael .
mommy never fails to send a birthday present to his father .	ibu tidak pernah salah lupa mengirim hadiah ulang tahun pada ayahnya .
maria was just about to say something when the door opened .	maria hendak mengatakan sesuatu ketika pintunya terbuka .
hey lim you ve gotten a lot taller since i last saw you .	hei lim kau sudah jauh lebih tinggi dibanding terakhir kali aku melihatmu .
i was the only one who didn t know nancy had been in prison .	saya satu satunya orang yang tidak tahu nancy telah dipenjara .
i m not the only one here who thinks ken isn t a nice guy .	bukan cuma aku saja yang berpikir bahwa ken bukanlah orang yang baik .
john doesn t know whether mary is telling the truth or not .	john tidak mengetahui apakah mary berkata sejujurnya atau tidak .
lim is the only one in our family who s been to australia .	lim satu satunya di keluarga kami yang pernah pergi ke australia .
carrie practices the piano at least thirty minutes every day .	carrie berlatih piano sekurang kurangnya tiga puluh menit setiap hari .
we want to make absolutely sure that david wants to do that .	kami ingin memastikan bahwa david ingin melakukannya .
mary s stew was so delicious that billy had a second helping .	rebusan mary sangat enak sampai sampai billy minta tambah .
sarah couldn t control himself when he saw mary kissing john .	sarah tidak dapat mengendalikan dirinya ketika mary mencium john .
darren didn t like the look of his nose so he had a nose job .	darren tidak suka dengan penampilan hidungnya jadi dia melakukan operasi plastik .
darren found it difficult to make himself understood in french .	darren mengalami kesulitan saat berkomunikasi dalam bahasa prancis .
jack was looking for place to eat that had reasonable prices .	jack mencari tempat makan dengan harga yang terjangkau .
kim will be driving through boston on his way to visit mary .	kim akan melewati boston dalam perjalanan mengunjungi mary .
the next door neighbor looked out the window when david yelled .	tetangga sebelah melihat ke luar jendela saat david berteriak .
mommy doesn t think he ll be able to finish the job by himself .	ibu tidak berpikir kalau dia akan bisa menyelesaikan tugas itu seorang diri .
daddy meets his girlfriend at this coffee shop every afternoon .	ayah menemui pacarnya di kafe siang ini .
billy lives in a three bedroom house on the outskirts of boston .	billy tinggal di sebuah rumah dengan tiga kamar di pinggiran kota boston .
i guess carrie didn t get around to painting the barn last summer .	aku rasa musim panas lalu carrie tidak menemukan waktu untuk mengecat lumbungnya .
if vijay would smile more often he d probably have more friends .	jika vijay lebih sering tersenyum dia mungkin akan memiliki lebih banyak teman .
mary was amazed at how precisely jack sensed how she was feeling .	mary takjub pada jack yang bisa dengan tepat merasakan apa yang ia rasakan .
jack blew his top when he heard that mary had gone out with john .	jack menjadi emosi ketika ia mendengar kalau mary pergi keluar dengan john .
david doesn t know the difference between a fable and a fairytale .	david tidak tahu perbedaan fabel dan dongeng .
lim is good with his hands and has built many interesting things .	lim memiliki tangan yang kreatif dan telah membuat berbagai benda yang menarik .
mommy said he was planning on visiting an old girlfriend in boston .	ibu bilang ia berencana untuk mengunjungi mantan kekasihnya di boston .
after getting through cusmias i was free to go wherever i wanted .	setelah melalui pemeriksaan pabean saya bebas pergi ke mana pun yang saya inginkan .
gary can no longer afford to live in the style he is accusgaryed to .	gary tidak lagi bisa hidup dengan gaya hidupnya yang biasa .
maria can t even play one song on his ukulele without making mistakes .	maria bahkan bisa memainkan satu lagu dengan ukulelenya tanpa membuat kesalahan .
nancy is married to mary now but at one time he was married to alice .	nancy menikah dengan mary saat ini tetapi sebelumnya ia menikah dengan alice .
mia asked me to do him a favor . however i couldn t do what he asked .	mia memintaku melakukan sesuatu untuknya . tetapi aku tidak dapat melakukan apa yang ia minta .
gary has been meaning to clean out his badly cluttered garage for years .	gary berniat untuk membersihkan garasinya yang sudah tidak dibersihkan selama bertahun tahun
nancy opened up the crate with a crowbar and took out a stick of dynamite .	nancy membuka peti kayunya dengan linggis dan mengambil sebatang dinamit .
if david hadn t helped mary she wouldn t have stood a chance of surviving .	jika david tidak menolong mary tadi mungkin dia tidak akan selamat .
darren had to read the sign on the door three times before he understood it .	darren harus membaca petunjuk di pintu tiga kali untuk mengerti isi petunjuk itu .
nancy waited for the applause to die down before he announced the next song .	nancy menunggu tepuk tangan mereda sebelum dia mengumumkan lagu selanjutnya .
the surgeon who did sarah s operation is very experienced and highly regarded .	dokter bedah yang menangani operasi sarah sangat berpengalaman dan dihormati .
carrie s wondering if any of his kids will remember that today is father s day .	carrie bertanya tanya apakah anaknya akan mengingat hari ini hari ayah ?
in north america business operates on the cusdaddyer is always right principle .	di amerika utara usaha umumnya berpegang pada prinsip pelanggan selalu benar .
mommy probably has better things to do with his time than sit in meetings all day .	ibu kemungkinan memiliki urusan yang lebih penting ketimbang duduk di ruang rapat selama seharian .
eventually someone is going to have to tell mia that he needs to behave himself .	pada akhirnya seseorang harus memberi tahu mia kalau dia perlu menjaga perilakunya .
mommy bought two chocolate cupcakes with vanilla icing and gave one of them to mary .	ibu membeli dua kapkek coklat dengan taburan vanila dan memberikannya satu ke mary .
michael wanted a sports car and wasn t at all interested in even looking at family cars .	michael menginginkan mobil sport dan sama sekali tidak tertarik dengan mobil keluarga .
the bomb blew johnny s house to smithereens . fortunately he wasn t at home at the time .	bom itu meledakkan rumah johnny menjadi berkeping keping . untungnya dia tidak sedang berada di rumah saat itu .
gary needed to store his stuff somewhere so i told him he could put it in our garage .	gary perlu menaruh barangnya di suatu tempat jadi saya menyuruhnya untuk menaruh barangnya di garasi kita .
sooner or later someone is going to have to tell john that he needs to behave himself .	cepat atau lambat seseorang harus memberi tahu john kalau dia perlu menjaga perilakunya .
david told mary that he wouldn t be able finish the job in the amount of time she d given him .	david bilang pada mary kalau dia tidak bisa menyelesaikan pekerjaaan itu dalam waktu yang ia berikan .
jack got in with the wrong crowd during his teenage years and was arrested for car theft several times .	jack terjerumus ke dalam pergaulan yang salah di masa remaja dan pernah beberapa kali ditangkap karena kasus pencurian mobil .
lee rolled out of bed at shuffled into the kitchen and put two slices of bread into the toaster .	lee turun dari ranjangnya jam lalu beranjak menuju dapur dan meletakkan dua potong roti ke dalam pemanggang .
after weeks of working flat out on the project darren can finally see the light at the end of the tunnel .	setelah berminggu minggu bekerja memeras keringat untuk proyeknya darren akhirnya bisa melihat titik terang dari usahanya .
michael felt the stiffness in his joints as he stood up after sitting in the same position for a long time .	michael merasa persendiaanya kaku setelah duduk lama dalam posisi yang sama .
darren didn t read the fine print on his insurance policy and was shocked to find that his claim wasn t covered .	darren tidak membaca cetakan kecil pada kebijakan asuransinya dan terkejut setelah mengetahui tuntutannya tidak disertakan .
daddy is graceful .	ayah adalah seorang yang anggun .
tom is john s boss .	tom adalah bos dari john .
tom looked at darren .	tom melihat kepada darren .
tom is maria s uncle .	tom adalah paman maria .
i met maria yesterday .	aku bertemu maria kemarin .
tom finally met gary .	tom akhirnya bertemu dengan gary .
darren is a lovely girl .	darren adalah gadis yang menawan .
darren is a pretty girl .	darren adalah gadis yang cantik .
tom and gary are done .	tom dan gary putus .
tom spoke up for johnny .	tom berbicara untuk johnny .
tom could replace johnny .	tom bisa menggantikan johnny .
tom dreamed about lee .	tom memimpikan lee
tom is alone with john .	tom sedang berduaan dengan john .
tom is beating up lim .	tom memukuli lim .
tom really misses vijay .	tom sungguh merindukan vijay .
tom wants to kill maria .	tom ingin membunuh maria .
david can speak japanese .	david bisa bahasa jepang .
i m tom and this is vijay .	saya tom dan ini vijay .
mommy has not started yet .	ibu belum mulai .
lee is a beautiful girl .	lee adalah gadis yang cantik .
gary is weaving a carpet .	gary sedang menenun sebuah karpet .
mia isn t my girlfriend .	mia itu bukan pacarku .
tom gave daddy his kidney .	tom memberikan ayah ginjalnya .
tom knew gary was hungry .	tom tahu gary sedang lapar .
tom never saw michael again .	tom tidak pernah melihat michael lagi .
tom tried to defend maria .	tom mencoba untuk melindungi maria .
tom was murdered by mommy .	tom dibunuh ibu .
lim likes milk very much .	lim sangat suka susu .
tom is sarah s best friend .	tom adalah teman baik sarah .
tom isn t as rich as lee .	tom tidak sekaya lee .
tom tried to deceive michael .	tom mencoba menipu michael .
why doesn t tom like sarah ?	kenapa tom tidak menyukai sarah ?
tom and mommy are here too .	tom dan ibu juga ada di sini .
tom and mia are outsiders .	tom dan mia adalah orang luar .
tom has confidence in mommy .	tom percaya pada ibu .
tom played a trick on darren .	tom menipu darren .
tom shot nancy with a rifle .	tom menembak nancy dengan senapan .
tom is waiting for lee now .	tom sedang menunggu lee sekarang .
tom really likes vijay a lot .	tom sangat menyukai vijay .
tom begged sarah not to leave .	tom meminta sarah untuk tidak pergi .
tom met sarah three years ago .	tom bertemu sarah tiga tahun yang lalu .
tom opened the door for maria .	tom membukakan pintu untuk maria .
tom opened the gate for gary .	tom membukakan gerbang untuk gary .
how could tom do this to johnny ?	bagaimana bisa tom melakukan ini pada johnny ?
john is carrying a watermelon .	john membawa semangka .
lim went to the beauty salon .	lim pergi ke salon .
tom has never seen sarah dance .	tom belum pernah melihat sarah menari .
tom paid no attention to kim .	tom tidak memperhatikan kim .
tom saw mia break the window .	tom melihat mia memecahkan kaca jendela .
did you tell tom nancy did this ?	kamu memberitahu tom nancy melakukan ini ?
tom asked kim to quit her job .	tom meminta kim untuk berhenti bekerja .
tom asked darren to stop working .	tom meminta darren untuk berhenti bekerja .
tom couldn t even look at david .	tom sampai tidak sanggup melihat ke arah david .
tom grabbed the book from ken .	tom merebut buku itu dari ken .
tom had a good opinion of lim .	tom dulu memiliki anggapan yang baik tentang lim .
tom is years older than gary .	tom tiga tahun lebih tua dari gary .
tom might not want to see vijay .	tom mungkin tidak ingin melihat vijay .
tom went to boston to see maria .	tom pergi ke boston untuk menemui maria .
i guess tom is looking for michael .	kurasa tom sedang mencari michael .
the girl standing there is billy .	gadis yang berdiri di sana adalah billy .
tom gladly accepted lee s gift .	tom dengan senang hati menerima hadiah dari lee .
tom offered nancy a stick of gum .	tom menawarkan sebatang permen kepada nancy .
tom received a letter from lee .	tom menerima surat dari lee .
tom went to boston to meet michael .	tom pergi ke boston untuk menemui michael .
tom appreciated jack s hard work .	tom menghargai kerja keras jack .
tom likes to listen to maria sing .	tom suka mendengar nyanyian maria .
tom may not be busy but lee is .	tom mungkin tidak sibuk tetapi lee mungkin .
tom realized daddy wasn t kidding .	tom menyadari ayah tidak sedang bercanda .
tom waited for sarah to come home .	tom menunggu sarah pulang ke rumah .
both tom and carrie are from boston .	baik tom dan carrie keduanya berasal dari boston .
i only told tom what daddy told me .	aku hanya memberi tahu tom apa yang ayah beritahu padaku .
i saw tom and mia leave together .	saya melihat tom dan mia berangkat bersama .
i thought tom and michael were happy .	aku kira tom dan michael bahagia .
billy isn t the right girl for you .	billy bukan gadis yang tepat untukmu .
tom and carrie did what they had to .	tom dan carrie melakukan apa yang harus mereka lakukan .
tom asked lim to lower her voice .	tom meminta lim untuk memelankan suaranya
tom borrowed some money from billy .	tom meminjam sedikit uang dari billy .
tom could do nothing to help mia .	tom tidak dapat melakukan apapun untuk menolong mia .
tom didn t talk to john all night .	tom tidak mengajak bicara john selama semalaman .
tom gave mia a box of chocolates .	tom memberi mia sekotak coklat .
tom has offered to walk darren home .	tom menawarkan darren untuk mengantarkannya pulang .
tom now knows darren wasn t kidding .	tom sekarang menyadari darren tidak sedang bercanda .
her behavior is my prilim concern .	perilakunya adalah perhatian utamaku .
i thought tom had gotten over nancy .	aku pikir tom sudah lelah mengejar nancy .
tom doesn t think gary wants to go .	tom merasa gary tidak ingin pergi .
tom doesn t want vijay to touch him .	tom tidak ingin vijay menyentuhnya .
tom grudgingly did what darren asked .	tom melakukan apa yang darren minta dengan berat hati .
tom knows jack is hiding something .	tom tahu jack menyembunyikan sesuatu .
tom pleaded with sarah not to leave .	tom memohon kepada sarah untuk tidak pergi .
did you tell tom that kim did this ?	kamu memberitahu tom kalau kim melakukan ini ?
tom couldn t possibly have hit gary .	mana mungkin tom memukul gary .
tom didn t meet gary or anyone else .	tom tidak bertemu dengan gary atau siapapun juga .
tom is talking to david on the phone .	tom sedang berbicara dengan david di telepon .
tom kissed mia and she slapped him .	tom mencium mia dan mia pun menamparnya .
tom may talk to johnny if he wants to .	tom akan berbicara dengan johnny jika dia ingin .
tom motioned for darren to follow him .	tom mengisyaratkan darren untuk mengikutinya .
tom nervously handed billy the knife .	tom secara gugup menyerahkan pisau kepada billy .
tom persuaded michael to join our band .	tom membujuk michael bergabung dengan band kami .
tom saw nancy coming down the stairs .	tom melihat nancy datang menuruni tangga .
tom saw ken getting ready to leave .	tom melihat ken bersiap untuk pergi .
tom saw maria heading into the woods .	tom melihat maria pergi ke hutan .
i have no idea what tom said to darren .	aku tidak tahu apa yang tom katakan pada darren .
tom didn t think he could trust darren .	tom tidak yakin kalau dia bisa mempercayai darren .
tom left about an hour ago with billy .	tom pergi sejam yang lalu dengan billy
tom saw jack s name on the list too .	tom juga melihat nama jack di daftar .
tom thought mommy seemed really happy .	tom mengira ibu terlihat sangat senang .
i thought tom would say hello to vijay .	ku pikir tom akan menyapa vijay tadi .
tom lives in the apartment above michael .	tom tinggal di apartemen diatas tempat michael .
tom realized lee was waiting for him .	tom menyadari lee menunggu dirinya .
tom tried to push vijay into the water .	tom mencoba mendorong vijay kedalam air .
tom david and john are in the kitchen .	tom david dan john sedang berada di dapur .
i wish tom hadn t told lee about that .	aku harap tom belum memberitahukan hal itu kepada lee .
gary decided never to see him any more .	gary memutuskan untuk tidak akan menemuinya lagi .
tom didn t notice how michael was dressed .	tom tidak tahu bagaimana michael berpakaian .
tom didn t understand maria s reasoning .	tom tidak memahami pertimbangan maria .
tom knew that johnny needed to buy a car .	tom tahu kalau johnny perlu membeli mobil .
tom knows that lim can t speak french .	tom tahu bahwa lim tidak bisa berbicara bahasa prancis .
tom showed darren how to sharpen a knife .	tom menunjukkan darren bagaimana cara mengasah pisau .
tom tried to persuade gary to help him .	tom mencoba membujuk gary untuk membantunya .
tom waited on the front porch for nancy .	tom menunggu nancy di beranda depan .
lee doesn t like men who look like tom .	lee tidak menyukai pria yang terlihat seperti tom .
tom and darren played tennis all day long .	tom dan darren bermain tenis seharian .
tom and vijay were talking to each other .	tom dan vijay saling berbicara .
i just assumed lim was tom s girlfriend .	saya beranggapan bahwa lim adalah pacarnya tom
i think i know why tom doesn t like mommy .	aku pikir aku tahu kenapa tom tidak suka pada ibu .
johnny and alice often wear the same thing .	johnny dan alice sering mengenakan pakaian yang sama .
tom and billy both turned around to watch .	tom dan billy keduanya berbalik untuk melihat .
tom asked john to go to a movie with him .	tom mengajak john pergi menonton film bersamanya .
tom could tell that michael wanted to leave .	tom dapat mengatakan bahwa michael ingin pergi .
tom showed up at john and mia s wedding .	tom hadir pada pernikahan john dan mia .
tom wanted vijay to go to boston with him .	tom ingin vijay pergi ke boston bersamanya .
tom could see john was about ready to cry .	tom melihat john ingin menangis .
tom doesn t know when ken will come back .	tom tidak tahu kapan ken akan kembali .
tom is alone in the dining room with darren .	tom berada seorang diri di ruang dapur bersama darren .
tom is going to wait until maria gets here .	tom akan menunggu hingga maria tiba .
tom makes a lot more money than gary does .	tom menghasilkan lebih banyak uang ketimbang gary .
tom picked up a rock and threw it at sarah .	tom mengambil batu dan melemparkannya pada sarah .
tom received a fax from johnny this morning .	tom menerima sebuah faks dari johnny pagi ini .
daddy declined an invitation to the concert .	ayah menolak undangan ke konser .
tom and david have recently moved to boston .	tom dan david pindah ke boston baru baru ini .
tom could tell that lim was pretty scared .	tom dapat mengatakan bahwa lim cukup ketakutan .
tom didn t know what darren thought about it .	tom tidak tahu apa yang darren pikirkan tentang hal itu .
tom loved daddy who didn t love him at all .	tom mencintai ayah yang tidak mencintainya sama sekali .
tom never would ve dated someone like vijay .	tom tidak akan pernah berkencan dengan seseorang seperti vijay .
tom read vijay s letter over and over again .	tom membaca surat vijay berulang kali .
kim is a girl who is pleasant to talk with .	kim adalah gadis yang enak diajak bicara .
tom barely avoided crashing into jack s car .	tom nyaris menabrak mobil jack .
tom doesn t know anything about vijay s plan .	tom tidak mengetahui apapun tentang rencana vijay .
tom said he didn t know why david was absent .	tom bilang dia tidak tahu kenapa david absen .
i m going to make a cake for sarah s birthday .	aku akan membuat kue untuk ulang tahun marry .
tom broke kim s expensive chinese ming vase .	tom memecahkan vas ming dari cina milik kim yang mahal
tom is always telling johnny that he loves her .	tom selalu meyakinkan johnny bahwa dia benar benar mencintainya
tom probably already knows that billy is here .	tom kemungkinan sudah tahu kalau billy di sini .
tom was surprised that gary had a motorcycle .	tom terkejut mengetahui gary memiliki sepeda motor .
tom wondered if kim could understand french .	tom ingin tahu apakah kim bisa memahami bahasa prancis .
tom s gym teacher is vijay s basketball coach .	guru senam tom adalah pelatih basket vijay .
i just assumed that ken was tom s girlfriend .	saya beranggapan bahwa ken adalah pacarnya tom
tom accepts that what gary said was the truth .	tom menerima bahwa apa yang dikatakan gary adalah kenyataan .
tom asked jack if she wanted to go for a walk .	tom bertanya pada jack apa ia ingin jalan jalan .
tom had a little trouble finding darren s house .	tom sedikit kesulitan untuk menemukan rumah darren .
tom probably doesn t know michael s phone number .	tom kemungkinan tidak tahu nomor telepon michael .
tom wanted to spend some time alone with kim .	tom ingin menghabiskan sedikit waktu berdua dengan kim .
you know tom is a friend of mia s don t you ?	kamu tahu kalau tom itu temannya mia kan ?
do you have any idea why tom doesn t like maria ?	apa kau tahu kenapa tom tidak suka dengan maria ?
tom and mommy have been dating for three months .	tom dan ibu telah berkencan selama tiga bulan .
tom and lim were standing close to each other .	tom dan lim berdiri berdekatan satu sama lain .
if anybody could convince tom it would be mia .	mialah satu satunya yang dapat membujuk tom .
tom asked maria to teach him how to do the waltz .	tom meminta maria untuk mengajarinya bagaimana caranya berdansa wals .
tom is much more relaxed when maria isn t around .	tom jauh lebih santai ketika maria tidak ada .
you plan to go out dancing with johnny don t you ?	bukankah kamu berencana untuk pergi berdansa dengan johnny ?
